10.ox
o.......o.oooo.....o
.....o.o....o..o....
......o...........o.
........o.....o....o
oo.oo...........o..o
..oo...........o....
.oo.o.....o.........
..oooo.......o...oo.
...o.oo....o..o...o.
o...o..o..o.....o...
