10.ox
..ooo.o.....o.......
o.......o.oo...oo...
......oo...o...o...o
.oo...o....oo.....o.
.o..o....oo.........
..o.....oo..o.......
..o...o.oooooo.....o
......o........o....
...........o...o...o
...o.o.......o....oo
