10.ox
o..o.o.o....o.o.....
.......o.o.....o....
.o....o.oo.....oo...
.ooo..o.o..o.o....o.
o....ooo....o...o...
.o.......oooo.o.o...
....o..oo.....o.....
..oo...o.o.....o....
.................oo.
.ooo.o....o..o..o...
