10.ox
............o....o.o
oo.....ooo.....oo...
...........o....o...
o...................
oo.....o......o..o.o
o.o.........o..o....
o..............o...o
..o.....oo....o.oo..
....oo...ooo.o.....o
o.......o..o..o.oo..
