10.ox
..o.....o.o....o.o..
........oo....ooo..o
..o....o........o...
.....o..o.....oo....
oooo.....o......oo..
o..........o.....o..
.....oo.............
.................o.o
...o.......oooooo..o
..o....o....oooo.o..
