10.ox
.........oo..oo....o
o......o..o.....o..o
ooo........oo....o..
......o..o.......o.o
.....o.....o.o..o.oo
.........ooo........
...oo..o.....oo.....
..o.o....o......ooo.
o.......o........o..
...............oo.o.
