10.ox
.o...o.o.o..........
.......ooo.ooo.o....
.......o....o...o.o.
.o...oo...........o.
...o.o..o.o.o...oo..
...o.....o........o.
..ooo..ooo.......o..
....oo.....o......o.
.o.o.....o.o..oo....
oo....o.o...o...o...
