10.ox
......oo......ooo...
..o......o.....o...o
.o.o....ooo.........
o..o...o....ooo.o...
....o.o.o...o..o....
..o.....o....o....oo
.....o...o..o......o
o.....o...o.....o...
.oo.oooo.o...o......
ooo..o....o..o.o.o..
