10.ox
......oo.o....o.....
..o.....o.o.....o...
.o..o.....o..oooo.o.
........oo..o.......
o..oo..oo.......o...
.o..o...........o..o
...o.o..o....o......
o.......oo..o...ooo.
...............o.o..
o.oo.......oo.o.....
