10.ox
...o.o......o..o...o
............o....oo.
..ooo....o.o....o...
....o...o..o......o.
..o.o..oo.....o.....
...oo.........oooo.o
o..........o..oo.ooo
.ooo.o.ooo.....o.o..
......o.o...oo...o..
.oo...o.....o..o.o.o
