10.ox
......o....oo.......
o...oo..o.o...o..o..
o..o.....oooo.......
..oo.......o.......o
.....o..o.o.o.ooo...
..o...o...o...o..o..
....o..oooooo.......
...o........o..o.o..
o...oo..o.o...o.....
oo.o........o.......
