10.ox
....oo....o.o...o..o
o..........o.o.o.o..
.......o............
.........o.o.....o..
...oo.ooo.o....oo..o
oo.................o
oo....o.o.....o..oo.
.o..oo.......o....o.
o..o..........o...o.
o....o......o.......
