10.ox
...oo.oo.........oo.
......o.....o..o....
...ooo...o...o..oo..
.oo....o.o.o.....oo.
..o.......o...o.....
.................o.o
o.o.......o..o..o...
oo............oo....
....o.....oo...o....
o...........o.ooo...
