10.ox
.oo.oo.o...o......o.
.o.o..o..o..oo..o..o
..o..o............o.
.o..o...o...oo..o...
.o..o.....oo....ooo.
.....oo.....o...oo..
.....o..o.o....o...o
.oo.o......o.o......
..o.................
.........oo.o...ooo.
