10.ox
.o..o..o.o.ooo..oo..
......o.ooo...o..o.o
.o.ooo..o.........o.
o.....oo...........o
..o.ooo.o.oo..oo.o.o
o...o.....ooo...oo..
....o.........ooo...
....o...o.o..o......
....o.......o.......
o.o....o.ooo.....oo.
