10.ox
oo..o........o....o.
..oo.o.....o...oo...
oo..oo.oo.o...o.....
.o..o......o....ooo.
.......o.....o..o.o.
ooo.....o.ooo..o..o.
.o.oo.o.....o.....o.
.......o...o...oo..o
oo...o....ooo....oo.
..o.oo.o..o...oo..o.
