10.ox
oooo....o.o...o...o.
..oo.o.o.oo...oo.ooo
...o.o...o.ooo......
..o.o.....o.oo......
....oo.o............
.o.o.o.o.........o..
....o...o...........
.oooo......o......o.
.o..ooo.....o.......
..o..oo......o..o...
