10.ox
..ooo...o.o..oooo.o.
o.....oo...oo....o..
..o...o.......o..o..
..o.o...............
..........o..o....o.
.o.....oo.....o.ooo.
.o...oo.o..o........
.o..o......o....oo..
oo..o.....o.......o.
......o.......ooo.o.
