10.ox
o......o............
.o...oo........o...o
o............oo..o..
..............oo....
.....oo..o.........o
.o......oo.o......o.
o.o....oo..o........
oo.......o....oo....
...oo..oo......o....
...o.o...o..oo.o....
