10.ox
.o...o....o...o.....
o..o...o...oo.o.o..o
.o...o.oo..oo.o....o
.o.oo........oooo..o
....ooo..o..o...o..o
....o.o..o......o..o
oo....o.o.......oooo
..........o....o..o.
.........o.....o.o..
o......o.........o..
