10.ox
oo.........oo.oo...o
.o..oo.o......o..o..
..o...oo...o..o..oo.
.o.........o.o..o...
......o.o...ooo.....
.o...o...oo.........
...oo.....o.....o...
oo...o.o.o.......o..
...o...............o
.......o............
