10.ox
..........o...o...oo
o...o.o.oo..........
.o...o..........oo.o
.o..o.........oo....
.o........oo.....o..
o....oo...o.........
.ooo..o..ooo...o..o.
....o...............
o....o.oo....o....o.
o.............o..o..
