10.ox
o..oo.....o.........
.o............o.o...
..oooooo..........o.
..o.............oo..
............oo.o.o..
....o.oo...........o
...........o....o...
.ooo..o......o.ooo..
.o...........o...oo.
.o...ooo...ooo.oo...
