10.ox
...o........o...oo..
...oo.o....o.oo.....
.oo......oo........o
..o.ooo........o..o.
..o.........o.o.....
o.o..o.o.oo.ooo..o..
.oo..oo.o...........
..o...o...o.o....o..
ooo.......o.oo...o..
.o....o..o.oooooo..o
