10.ox
.oo...oo....o.o.....
.o...oooooo...o...o.
oo......o.....oo.o.o
.....oooo.o.......oo
o...o.......oo.o..o.
....oo..o..o.....o.o
......ooo..oo..oo...
o.o...........o.o...
......o...o.o....o..
.o.o.....o..o.......
