10.ox
...o..........oo....
.......o...........o
..o.......oo....o...
.....oo...o..o......
o.o.oo....oooo...o.o
.........o.oo....o..
...o.............o..
....o..o..oo....ooo.
oooo...o.o...o.o....
....o..o...o...o.ooo
