10.ox
....o..oo.o.o.o...oo
o.oo.oo........o..o.
o...............o...
o........o.......o..
...o....o..o......oo
.o..o..oooo.o.....o.
..oo....o......o.o..
o..o.oo........oo...
...o..o....o........
oo.oo......o..o.o...
