10.ox
ooo...oo....o.o..o..
..o..o..o..o.o...o..
oo..oo.oo.o...o.....
....o.o..........o..
.o..oo.o............
.o....o...oo..o..oo.
..oo.o..o....oo.....
.o.ooo...o..........
o.oo.o.........o..oo
..o..o....o..ooooo.o
