10.ox
o....o..o..o..o.....
.o.....o......o.o.o.
.o..o....o.o..o....o
.o..o.oooo.......o..
o....oooo....oo.o...
ooo.o.o.o..ooo...oo.
.o......o...o...o...
.o...o......o.......
o....o.oo..o........
......oo.....o..o...
