10.ox
.....o.o..........o.
.................o..
....o..o......o.o...
...o...o..........o.
...o...........o....
...........o....o.o.
.o.o..o.o...o.......
......oo....o...oooo
.........o.....o....
........oo.o...oo...
