10.ox
.o.o.o...oo.o.......
...o.o....o...o..o.o
.oo.......o...o..ooo
........ooooo.......
o.o...o.............
..o..o.......o......
.o......o.....o.....
o..o...........oo...
o..........o........
o.o.o..o..o..o..o...
