10.ox
....o.o...oo.oooo...
.oo.......o....o...o
..o.o.......oo....o.
......o..o..........
o...oo..o.......o...
o.............o....o
o.ooooo..o.oooo.....
...o.......o.o.oooo.
.....ooo...........o
.o.....oo......o....
