10.ox
......o..oo.....o...
..oo.....oo....o.o..
......o...oo.......o
.o.....o.....o..o.oo
..oo...o...o....ooo.
o...o....o.o.o......
....o......o...o....
.o.....ooo......oooo
.oo....ooo....oo....
..o.o.......o..o..o.
