10.ox
.ooo..oo..oo.....o.o
....o.....oo.o......
....................
ooooo...o..oo..o..o.
......oo....ooo..o..
..oo..o........o....
.o....oo.o.oo.oo....
o.oo.oo..o..........
.ooo..........o....o
..o.ooo..oooo..o..o.
