10.ox
.o.o.........o......
.o..o...o...o.....oo
o...ooo.o...oooo.o.o
..o..o...o.....ooo..
.....o.....o........
.o.....o...oo.o..o..
..o...o.o....o..o...
.o..oo....o......o..
...o..o..oo...oo....
o..ooo.ooo...o....o.
