10.ox
....o..o.....o.o...o
.....o.o.....oo.o...
..o.oo.o.oo.o.......
.................oo.
..o............o....
..o...oo...........o
.....oo...o..o.....o
.o.o..oo.o.ooooo..o.
.o.ooo..o.......oo.o
o.o......oo..oo.....
