10.ox
....o.o...o.........
...o.oo.....ooo.o...
............o.oo...o
o.o.......o.......o.
oo..o........oo.o...
.....oo.............
...oooo...........o.
....oo........o..oo.
o....o.............o
..oo..........o..o..
