10.ox
o.o.oo..o.o.o.o.o..o
.....o...o....ooo...
..o..........o.o..oo
....oooo..ooo.o.o..o
o..o....ooo....ooo..
oo....ooo..o...o...o
o..o...o...o.ooo....
o..............ooo.o
...o............o...
....oo..o...........
