10.ox
o............o......
o.....o..oo.........
o....o....oo...o...o
....o.ooo........o..
...o.o..oo..........
...o.o.o...ooo....o.
o..oo..o......o.....
........oooo...o....
o....ooo.o..o.o.oo..
...oooo..o..oo.o....
