10.ox
ooo.o......o....oo..
.o..o...o.o.o...o..o
....oo.....o.oo.....
.oo...o....oo.o.....
.o...o..o......o.o..
.oo......o..........
...o.o.o..o.o.....o.
.o.oo........o...ooo
..o..oo....o..o.....
.o.o.oo.o...o.o....o
