10.ox
..o.o.........oo....
.oo.o.oo....o...ooo.
....o...o.......o..o
..oo..o..o.o........
.....o.o.......o....
.ooo.o....o.o.......
..........o......o..
oo.o..o...oo........
.........oo.o..ooooo
...o...oo..o.o......
