10.ox
.o..o....oo.o......o
..o.o..o......o.....
o.o.oo...o...o......
...o.o.....oo.......
............ooo.....
...o...oo....o......
.....oo.o...........
o..oo...oo..o..o....
.o...o.......oo.....
.oo...oo..o.o.....o.
