10.ox
.oo....o.oo.........
.ooo..o.....o..o....
....o......o..o...o.
.....o.o.....o.o..oo
............o..o.o..
...oo..o..ooo...oo..
....oo.o......o.....
.o.o............o...
o.....o..o..........
............o.o....o
