10.ox
o..o.....oo........o
.o..o...ooo......ooo
oo.oo......o.....o..
.oo.oo...o...o.....o
.....oo.....o....o..
..........o.o...oo..
....o.....oo.o......
o.........oooo..o..o
o.........o..o...oo.
..oo.o.....o.oo...o.
