10.ox
......oo...o.ooo....
....o........o.o..o.
..o........oo.......
....oo......o..o..o.
..o......o........o.
oo...oo.....oo..o...
oo........o..o.oo...
.....ooo............
..........o..oo.....
.o......ooo....oo.oo
