10.ox
o..o........oooo.o..
.o.......o....o.o...
o.o.oo.....o..o.....
...o.....o...o..o...
.oo...ooo..o....oo..
.......ooo......o...
..o....o..oo.......o
o....o.....o....o.oo
o..oo.o.............
......o..oo....o....
