10.ox
o..ooo.oo.o.o.o.....
.....o....o..o...o.o
.o....o....o........
.......oo.o....oo.o.
o.o.o...ooo.o.......
.o....o..o...o.o....
o...oo.o.......oo...
...oo......o.....o..
..............oooo..
..oo....ooo..o.o.o.o
