10.ox
..o...o..o..........
..ooo...o.....o.o...
.o.oo...o...........
..o.o.o...o.oo.o....
o..o......o.....o...
...o..o..o......ooo.
....oo..oo.oo.......
o....o..o..o.......o
ooo...ooo...oo...o..
.o..o.o...oo.o...o.o
