10.ox
.o......o....oo.....
....ooo...o..o.....o
..o....o..o.........
..oo................
....oo........o.oo..
..o...oo..oo.o...oo.
.o..........ooo..o..
..oo....o.........o.
..o.....o..ooo......
.....o....o...oo....
