10.ox
..o.........o.o.....
..o..o..oo.oooo..o..
..o..o....o...o...oo
.o..o......o......o.
....o..o...oo.o....o
......oo..oo.....o..
..o.o.o.o....o......
..o..o..o......oo...
.....ooo....o...o.oo
.o..........o.o..o.o
