10.ox
........oo...ooo...o
.o.o...oo..o.o.o...o
.o...o.o...o.....o..
.......oo....o.o....
......o...........o.
..o...o.............
..o....o..oo..o...oo
.o......o....oo..oo.
.oooo..o.......o.o..
....o..o....o.o.o.o.
