10.ox
...o.......o......o.
.oooo.......oo..o..o
.......o.o.o........
....oo..oo....o.....
.oo.o....o.o.....o.o
..o.o..oo..o...oo...
......o.o.......oo..
..oo....oo..o.......
o.oo....oo..........
..o........oo.ooo...
