10.ox
.oo...o.o...........
.....oo...o...o.....
..o........oo......o
..ooo.o......oo.....
.oo..........o..o.o.
.....oooooo.......o.
....o....o....o..o.o
.......o...o.o....o.
...o..ooo...oo......
o.......o...o....o..
