10.ox
..oo................
..o....o.oo...o.....
.o........o....o.o.o
..ooo.o....oo.....oo
....oo...ooo....o...
....o.o............o
...o..o.o..........o
o..o....o.o......o..
.oo.o....o........o.
.o.o...o.......o....
