10.ox
...o............o...
..o............o....
o.....o..o......oo..
o..oo.o..o.......o..
.......ooooo.....o..
...o..o......oooo...
..oo.o...o..o.......
..oo..o.........o.o.
o..o...o.o.o....o...
.....o..oooo..o.....
