10.ox
.....o..o.........oo
..................o.
oo...o..o.o........o
o.........o.o.o.o.o.
..o.....o........o..
o...o....oo.........
......o.o...o.....o.
........o....ooo..oo
oo...o....o.o.oo....
.....o.o......o.....
