10.ox
.....o.......o......
...oo..........o..o.
o..oo.....o.........
.o...o.o...........o
..oo.o.........o....
o....o.oo...o.oooo..
.oo...o..oo.......oo
.ooo...o....o..o...o
..oo...o...o...o..oo
.o...o....o..o...o..
