10.ox
....oo..............
.o....o.............
o...o....o...oo.o...
...oo.........oo...o
oo..o...........o...
o.....o.......o.....
.o..o...o.o....o....
.oooo....oooo..o....
.o...o.o...o.....oo.
.o....o...o.oo...o..
