10.ox
..o.oo.o..o.oooo.o..
.....ooo..o..o...o..
.o.o...o..o..o......
.o..o.o....o....o.o.
..o............o.oo.
.o.....o...o.......o
o....ooo.....o......
oo............o...o.
...o.....o.o........
..o.....o....o.oo..o
