10.ox
o....o..oo.o.o..o.o.
......o..o........o.
.........o..o.....oo
....oo.o.oo.o.o..oo.
..o......o..........
........o....o.o...o
.oo.o.....oo..o..oo.
.ooo.o....oo.o.oo...
oo.........o......o.
.......o...oo.o..oo.
