10.ox
.o......o....oo.....
........oo..o.......
o........oo.....o...
........o...o...o...
....o..o............
.o....oo........ooo.
..oo..............o.
.......oo..o.......o
.o.......ooo.o.oo..o
.o.o...oo........o..
