10.ox
..o..ooo.o.....o.o..
o...o.o....o.oo...o.
..ooooo...o...oo....
o...........ooo..ooo
...o..o....o........
.....o..o.o......o..
.......o.o...o..oo..
o.o.ooo....o.......o
.......oo...o....o.o
oo......o....o...o..
