10.ox
.............o...oo.
.....o.o...oo...o...
.........ooo.oooo...
.....o..oo.o....o...
o....o....oooooo....
..o.....o.o.........
o.oo..o...o...oo....
oo..........o....o.o
.......o..o...o...o.
oo.....o......o..o..
