10.ox
...oo..oo..o...oo.o.
........o.......o...
.o..o.o.oo..o......o
oo.oo.ooo..oo.o.....
...o......oo.o.o.o.o
..oo..o......o...o..
...ooo..o......oo...
......o..o.o....ooo.
........o..o..o.....
o...o...o..o...oo.oo
