10.ox
....o.o.o...o.....oo
................o...
......o.oo.o..o.....
.............oooo...
....oo..o....oo.....
.o....o.......o.....
.o.....o.......o.o..
o.ooo....o...o..o..o
o...o.o....oo..o...o
.......o...........o
