10.ox
.........o.o.oo.....
.....o.ooo....o.....
.......o..o...oo.o.o
...o......o......o..
o.................o.
.........o..........
..o.oo......o...o...
..oo........o....oo.
o...o............o.o
o..oo......o...o....
