10.ox
....o.oo......o....o
.......o....o......o
..oo.....o.o.o.o...o
....o..o...oo....o..
..o..o.....o...o..o.
.o.....ooo....o.o..o
...ooooo.........o..
....o.....o.oo....o.
o........o..........
o..o.oo.o.o...o.....
