10.ox
o.o..oo.o..oo....o..
..oooo.o.....ooo....
.....o..oo.o..o.....
.oo.........o.o.....
oo.........oo....o.o
....ooo.o..o.oo..o..
o......o.oo.....o..o
..o..o.ooo.o.o.oo...
..oo.oooo..........o
.o.oo....oo.o....o..
