10.ox
.o............o.....
..oooo..o.o.o.oo..o.
..o.....o..ooo.oo..o
.........oo..o....o.
................o..o
o...oo......oo......
.........o.o........
oo.o........o...oo..
.o.oooo.ooo.o...o...
......o..o.o......o.
