10.ox
o..o..o.....o..oo.o.
o...o....o..o....o..
o..o.o...o........o.
..........oo....o..o
.oo......o...o....o.
ooo........o.o...o..
....ooo.o..o.o...o.o
...ooo.......oo.....
...ooo........o.....
oo...oooo.oo........
