10.ox
..o...o.......o..o..
oo.o.o....o..o......
...o..o.....o.....o.
.o.o.o.o..o...o.oo..
............o..oo...
..o.oo.oo....oo..o..
o.oo......ooo..oo.o.
o...o...o..o........
....oooo..o......o..
o.o.o.....oo....o...
