10.ox
o.oo....o...........
o.o............o...o
....o...oo...oo...o.
...o.o.oo...o.oo.o.o
o....oo..o.o......o.
oo.....o....o.o.o...
....o.o.....o.oo....
o....oo....oo.oooo.o
..o.o.o..o...ooo..o.
.ooo......o...oo...o
