10.ox
......o....oo...o..o
oo.oo.....o.o..ooo.o
.....oooo...........
.o...o..o.oo.o......
.ooo..oo..o..o..o..o
....o...o...o..o.oo.
..o.oo.....o.....o..
.o.o..o...o.o...o...
...o....o.....o.....
..ooo.....o.....o..o
