10.ox
...oo.........oo.o.o
.o...ooo..o.....o...
....o...ooo.o.o....o
o......o.o...o...o..
......o.........o..o
.o.o...o...o.o.o.o..
....o.o...........o.
...o.o..o......o.o..
oo......o.o.........
....ooo...oo..o....o
