10.ox
.....o..o.ooo..o....
.oo..........oo.o.oo
oo........ooo....o.o
..o.o...............
.o.oo..o...o...oo...
....o.o...oo.......o
........o...o.o.o...
....o....o.oo.......
...oo....o.oo......o
....o......o...oo...
