10.ox
...oo.....oo.o......
.........o..oo.oo...
....o..o..........o.
.oooo.o...oo...o....
.....oo..........oo.
........o..o....oo.o
.o.o......oo...o..o.
.......o..o..o......
o......oo.........o.
..o.o.o....o.o......
