10.ox
..o.oo...o...oo...o.
............o....o..
ooo..........o.ooooo
....o.o....o.....o.o
...o........oo......
.o.....o.o.o..o.o...
..........oo.....o..
.ooo........o....o.o
o...oo.oo......o.o..
..o..o.....oo....oo.
