10.ox
oo.......oo..o....o.
.o.o.o..o....o.oo...
....o....oo..o..o..o
..o...o..o.ooo......
...oo.o.oooo.......o
oo..o..o..oo..o..o..
....oo..oo.oo....o..
o.........o.......o.
..o....o..oo........
......oo......oooo.o
