10.ox
..oo.........o.oo.o.
.o.....o...o......oo
.o.oo.oo.o........o.
..o....o.oooo..o....
oooo.o..............
...oooo......o...o..
o..oo.o.oo..o..o.o..
.o.o..o...o.........
.o.......o...o.o.o.o
...........oo.o.....
