10.ox
......o..o...ooo....
.............o.ooo.o
.oo.o..oo......o....
.o..o.o.....o.o.....
.o..............o...
.o....o.......o.o...
.o.o.o.o.........o.o
.........o....oooo..
o....o....o.........
oo....o.o......oo.oo
