10.ox
...o.o..ooo..o...o..
..ooo.o.o....oo..o..
....o...o.....oo....
o.o.....o....o.oo.o.
o........oo..oo.....
....ooo.......ooo.o.
...o..o...........o.
....oo.........o....
.o.o..............oo
...........o...o....
