10.ox
..oo...........oooo.
....oo......oo......
..o..o...o.o.o..o.o.
..o........o.o......
.......o.....o..oo..
....ooo...........o.
...............ooo..
.........o....oo....
o.o.o.o....o.....o.o
oo.o........o..ooo..
