10.ox
.oo.o.oo..oo.o.....o
..o..o....o.oo.o.ooo
.o......o.......o..o
...........o.o.o.o..
.o..o...o.o.o.....o.
.....o.o.o..o..o..o.
......o.o.....o...oo
.o..........oo.o....
..........ooo.o.....
....oo...........o.o
