10.ox
.o..o....oo....o..oo
...........o.oo.o..o
.o.o....o...o.....o.
.o.o...o...........o
oooo..o....o.o.o....
.oo....o.o..o.......
...o.........o.....o
..o.o...oo...o......
o..o.o.o.......oo...
......o..o.o........
