10.ox
...oo...o.....oo..o.
o.......o...oo.o....
..o...o..o......o..o
...o...ooo...o......
....................
oo.....o.....oo..o..
.o.....o......o.o..o
.o.oo..o.o.o..o...o.
.o...........o....oo
ooo.....ooo.........
