10.ox
o.....o...o.o.......
.....oo....o.o......
ooo.o....o...o......
.o.....o.....o..o..o
...o..o...o.oo......
...oo.oo.o.....oo...
...........ooo.o.o..
..o.o.o.o........o..
o............oo...o.
..o........o....oooo
