10.ox
..oo........o.o.ooo.
o........o..o.......
.o.........ooo......
.....o..o...o..o.oo.
o..o....o.....o...o.
o......o...o..o.o...
.oo...ooo....oo...o.
oo....oooo...o......
.o.........o..o..o..
oo...oooo.o.o......o
