10.ox
.............oo.o...
..oo......o...o.o.o.
oo.o.......o....o..o
.o......o.oo.oo...oo
...o...o.oo...o.....
.o......o...o.......
...o.........oo.....
......o.o.....o..o..
.....o....o..o.....o
o.o..o..o...........
