10.ox
o......oo.oo.....o..
..oo...oo..o.......o
.o..ooo....oo..o...o
oo..........oo..o...
o...o..oo....o......
oooo.o.....oo.....o.
oo.o...o.....o......
o..o..o...ooo......o
.o....o.o.o.o.o...o.
...o...o...ooo.....o
