10.ox
.....o.o....oo...oo.
....o..oo.o.oo......
o....o....o..oo.....
...o...oo......ooo.o
..ooo..........o..o.
o.....o....o..o...o.
........o.o..oo.....
...o...oo...o.o....o
....o........o.....o
.oo...o.......oo.oo.
