10.ox
.......oo.oo...o....
ooo.oo........o.o.o.
....o.o...o...o.....
.o.o.o..o..o...o.o..
ooo..oo.o.ooo...o...
...o..o....o......oo
o.o............o...o
...o.......oo......o
...o......o...o....o
.o...oo.ooo.........
