10.ox
......ooo..o...o....
ooo.o.o..ooo.....o.o
.....o.o..o.o..o....
..o..o..o..o.o......
.....o.o.o.......oo.
o.....o.o.o.........
...ooo.o.o..oooo....
....o..o........oo.o
..o......o..oo.....o
.o.....o.o....o.....
