10.ox
..o.....o.......o...
.o..o.....o..o.o....
o......o............
.......o.....o......
.o..o..........o.o..
o....o.o.oo..oo..oo.
..ooo....o.....oo...
...oo.o.o....oo...o.
..o....oo..o.....ooo
........oo.o..o...o.
