10.ox
.o....oooo.o....o...
...oo.........ooooo.
.ooo....o...o..o....
..................o.
o....o.oo...oo.o....
..o.oo.o....o..o.o..
...................o
....oo.....ooo.....o
...o.....o..oo...o..
.o.o....ooo.o......o
