10.ox
......o.....oo......
...oooo...oo....o..o
o....o..............
o..o.ooo.o...o.....o
oo.ooo.o.o..o.......
o.oo....ooo.oo......
oo......o..........o
...oo..o.o....o..o..
o...................
..o.....o.o...o.....
