10.ox
...o..o.....oooo....
o.o.................
....o...............
o........o..o......o
..o..oo...o.....oooo
.......o.oo..oo.o.o.
oo......o..oo.....o.
.oo..oo........o....
..o..ooo..o...oo....
...o..o......o..o..o
