10.ox
o..........o...oo...
.o.o........o.....oo
..o.o.o.o...o.......
..ooo.....ooo....ooo
......o......o.o....
.o..o.......o....oo.
......o...o.oo...oo.
o.......o.o.o.o....o
..o.....o.........oo
..o...o....oo...o...
