10.ox
ooo...o...oo.o.o....
......o.oo......oo..
o..oo.o...ooo..oo...
....o.oo.o...o..oo..
........o.....o.o...
..o....ooo........o.
..o...o....o........
......oo.......o.o..
...o.o...ooo........
.o....o.oo.o.....oo.
