10.ox
..o....o.o.......oo.
....o..............o
....o..........o....
o.ooo.o..oo........o
.ooo.............oo.
.o..........ooo.....
.ooo....o...........
.o..oo.....o..o.o..o
..oo.ooooo..........
......oo...o........
