10.ox
.o...o..o...o.....oo
......oo.......o....
.oo....o..........o.
oo.o.oo..o..........
....o..oo.o.........
o..o..o...oooo.....o
..............o.....
.o...ooo......o.....
...o..oo.......oo..o
o.o...o........o.oo.
