10.ox
o..oo...o.o.ooo.oo..
.oo.o......o......o.
..oo.....o.oo.o.....
...oo...o.....ooo.oo
....oo........o..o..
.o......ooo.....o...
o.......o.oo...oo...
oo.....o.oo..o...o..
o.....o......o.o.o..
....oo.....ooo..oo..
