10.ox
...oo..o..o......oo.
..oo.......o..o.....
.o..o..o..o..oo.....
.o...oo...oo...oooo.
.oo.o.o..ooo...oo.o.
.oo..o.oo.ooo.......
.....o.o..oo......oo
o.....o.o......oo...
.o.o..........o..oo.
o.oo...o..o......oo.
