10.ox
...oo.....o.....oo..
....o..o.o......o..o
..o.......ooooo.....
o.oo.o.........oo...
..o......o...oo.....
...............o.o..
...o.oo..........o..
o.............o.....
....oo.o..o..oo.o...
.o..o...o..o.......o
