10.ox
.....o........o.....
....o.....ooooo...o.
.o.o.o.o............
oo..o..o...o.o.o....
....................
o.o...o.......o..o..
.....o..o........oo.
.......o....o....oo.
....o.......o.......
o........oo..o....o.
