10.ox
...o.oo......o...o..
.o.o.o..o.ooo....ooo
o..o..ooo.o....o..oo
o....o...o...o......
..o.o.o........o....
o.....o......o..o.oo
o...o..o.o....oo....
.o.o....oo....oo....
.....o.oo....o.o...o
...o...o..........oo
