10.ox
oo................oo
oo..o.....o.........
.o.....o.o....o..o.o
.....o....o..o.oo...
oo...o.o.o.o.....o..
oo.....o.o...oo.....
oo..o...............
........o.o.........
o...o.o...o.......o.
.oo......o.o..ooo...
