10.ox
..o..o.....oo.o.....
.o.oo............ooo
......o...o..ooo..oo
.o......oo...oo.o.o.
.....o....o..o......
.o.o..o..o.......oo.
o..o.o..o.o..o.oo.o.
................o...
...o..oo.o.......o..
.o........oo....o...
