10.ox
..o.................
......o.oo.......o..
o...o....o.o..oo.ooo
.o...o...ooo.oo.....
ooo......o.......oo.
..............o.....
..o..o..o.....o..o..
.........o.oo.......
.o..o...............
..o......oo..oo..o..
