10.ox
..oo....o.o..o.....o
.......oo.....o.....
..o.o.......o.o.o...
o..o...o.o..........
ooo.oooo..o........o
.o.......o.....o....
.......o..o.o....o..
..o....o.....o..o.o.
.....o.o.o...o..o...
.o........oooooo.ooo
