10.ox
.oo.o..o.o.o.oo....o
..o.....o...o......o
..o.ooo....oo....o.o
o...o...oooo..o.o...
oooo...o............
.....o...o.o....o.o.
........oo.o.oo..o..
o.....o..........o..
.o..o......oo.......
.oo.................
