10.ox
..o......o.o.......o
......o.o..o..o...o.
..o..o.o.o...o.o..oo
o..o.......o....ooo.
..o...oo....o..o...o
..o.....oo....o.o..o
.oo.......o..o...ooo
...oo.............o.
o..oo....oo.........
......o.............
