10.ox
.o.......o.oo..o.o..
oo..........oo......
o......oo.o..o.....o
.....o......ooo..o..
o......o..o.....oo..
.o..o...............
.......o..o...oo....
...oooo...o.o..oo...
..ooo...oo.........o
o.......o...o.o.o...
