10.ox
..o........o......o.
...o.o........o.....
.o.o...oo...........
........ooo.o....oo.
....o...............
..................o.
.oo...oo.....ooo....
o..o....o..o...o...o
.o.o.....o.o.o.o...o
.o..o......o..oo.oo.
