10.ox
...ooo....o.....o.o.
..o..o.....o.....o.o
o.......o..oo.o.....
o....o......oo......
.oo.....o...o.......
.......o..o.oo..o...
..o..o...o...o..o.o.
...oo.o..o.......ooo
......oooo.oo.o...oo
..o..........o..o.o.
