10.ox
.....oo.............
...........o.oooo...
.o...o....o......oo.
..o........oo.....o.
.o.....o.....o.oo...
o...oo....o..o.o....
........o......o...o
.o....o........oo.o.
o.....o....o..o.o...
o..o...ooo.........o
