10.ox
o......o...o......oo
....o...........oo..
o..oo....oooo.......
.........o........o.
.oo.......ooo.o..o..
o.........o....o....
...oo..o...o....oo.o
.ooo....o......oo..o
........o.......oo..
ooo.o...o.....o...o.
