10.ox
........o.....o.....
..o...o.o....o..o.oo
.o.......ooooo....oo
.....oo....o........
..o...........o.....
.o....o...o.o.o....o
.....oo.......o.....
.ooo.......oo...o...
o.....o........o..o.
....oo.........o...o
