10.ox
oooo.o..o........o..
o......oooo.o.......
.....o.....o.o.oo...
....o.ooo....oo.....
.....o..........oo..
o..........o.o......
o.o.......o.....o...
.o...o......o.....oo
oo.....o...o...oo...
o....o...ooo......o.
