10.ox
.....o.ooo.o.......o
..................o.
.....oo.....o.oooo..
...................o
......o.oo.o.o.o....
oo.ooo.............o
....o.o.............
..o....ooo..o...o.o.
...oo.....o.o....o..
.....ooo.....o...o..
