10.ox
o..o..o..........o..
o..o.o......o...o...
.......o...ooo..o.o.
oo.oo......ooooo....
........oo.....o....
....o.....o.oo.....o
..........o.........
o...o..oo...o.oo..o.
........o..o..o..o..
ooo.o..o....oo...oo.
