10.ox
oo...o.o....o....o.o
o.....o...........oo
.....o...oo...ooo...
oo.ooo.o..o.o..o.o..
o.o.....oo.........o
..........o.o.......
.....o..............
....o..o....o.o.....
....ooo.....o.....o.
oo.ooo.........o...o
