10.ox
o.......o.........oo
ooooo..o.o..o.......
.o.oo.....o..o..oo.o
.........oo.o.oooo..
.o..o...o......o.o..
....oo..o..oo...oo..
o....o..o.o...o...o.
...o.....oo.ooo..oo.
.o.o.oo..o..........
.o...o.....o.o...o..
