10.ox
...................o
..o.o...o....o..o...
...o.o.....oo..o....
o.....o....o..o.o...
o...o...oo....o.....
oooo..o.....o.o.o.oo
..o....o..o..o....o.
...o..o.o..o.o.ooo..
..oo...o...o.ooo...o
o..........o..oo..oo
