10.ox
......o.....o.....oo
......o...o.oo.o.oo.
.........oo.o.......
ooo..o...........oo.
.........o.o.o......
.o.......o....o.....
o............o..o...
....o.....o.........
.o...........oo.....
.o....o..o.......o..
