10.ox
..oo..oo....o.....o.
.o..o...........o.o.
...oo.oooooo.o.ooo.o
..o.....o...o.o.....
o..............o...o
......o.ooo.o.....o.
.oo........o......o.
......o.o..o..o.....
...oo...o........o..
o...o...........o...
