10.ox
....oo.......oo.....
.........o..oo.o.oo.
.....ooo..oo..oo.o..
.........o...oo.....
.....o...o..oo......
..o....o.....o.o....
oo...o..o...........
................oo..
o...o..o..o...o.o...
......o.o.oo.o......
