10.ox
o....o.....oo.o..o..
...o...ooo........o.
......ooo..oo....oo.
.....o.oo....o...oo.
.oo.oo..o........oo.
..oo................
...............o..o.
.oo...............o.
......o......o.oo.o.
...o...oo...........
