10.ox
........o..o..oo....
o......oo...oo.....o
oo..........o.......
o...o....o........o.
.....o.o..o....o....
.o...o.......oo....o
.....o..o.oooo..oo..
.....o......oo.o....
.o.o...o............
.......o.o.........o
