10.ox
..oo..o.............
....ooo.....o..o.oo.
........oo....o.....
.o..o.o...ooo...oo..
ooo....ooo....o....o
......o...oo....o.o.
....o.o.o.........oo
.....oo......o......
...o.o.....oo.o..o..
o..o................
