10.ox
o.......o...........
...o...o............
o.o........o........
...oo....o....ooo...
...o....o...........
o.......o........oo.
...........oo.....oo
.o....oooo........o.
..o.................
ooo.o.o.o......o.ooo
