10.ox
.......oo...oooo...o
..o.o..oo..oo.......
.....o.o..o....o....
oo...o....o.oo......
....o........o......
o....o.........ooo.o
...oo...o.o.....o...
..o..oo.o.o.oo......
.o............ooo..o
..o.....oo..o..oo...
