10.ox
o...o...o.....o.....
..o........o...oo..o
..o...oo....oooo....
o.o.o..........o....
.......o.ooo.o.o...o
.o......o..o......oo
..o...oo.ooo....o..o
.o..o.o....o.ooo..o.
o...o...oo...o......
.o...oo.o.......o.o.
