10.ox
....................
o..o.............o..
......o.ooo..oo.....
o......o..o.o......o
..o.o....o..o..oo.o.
oo..oo........o.....
.o.o.........o......
.o.....o.oo...o.oooo
o..........ooo.o....
.o.oo..o.o.ooo..oo..
