10.ox
o....o.o.o.....o....
...............o..oo
.......o.oo........o
.....oo...o...o.....
..........o..oooo...
.o.o....o..o...o..o.
.o...o...o........oo
.oo............oo...
o.oo..oo..o..oo..oo.
oo............o.o...
