10.ox
..oo.......ooo...o.o
o.o.o......oo..oo..o
oo........o...o....o
o...oo.o.o..oo....o.
.......o..o...o.o..o
....................
....o.o......o...o..
o..o......o.o...o.o.
.......oo.....o..o..
......oo...o..o.....
