10.ox
.oo...o..o..........
...........o....o...
..o....o.....o.o...o
......o......oo.....
o..o.......o....o...
...oooo......o....oo
.oo...oo..o.oo.o....
.o.o...o.o..o..o...o
o.......o.......oo.o
.o.o..o.............
