10.ox
oo.o.........oo...oo
.o.oo....o..o.......
....ooo..o.....o....
o.....oo..o...oo..oo
o.o.o.o.............
o..o.........o.oo...
.o.o.o..o.o..o......
..o.o............oo.
o..o.ooo.o...o.o..o.
..o..o.........o.o.o
