10.ox
....oo....o.........
..o.....oo.....o..o.
.o..o....o...o...o..
...o..oo.o..o.o.....
.........oo...oo.o..
.....o......o......o
o....oo...o...oo...o
....o....o.oo...oo..
....o...............
..oo..o..o.......o..
