10.ox
.o.........o..oo.o.o
....................
.o...oo...o...ooo...
.o..oo.......o......
......oo...o....o...
oo..o.o.o.o.o.....o.
o.........o.....o...
o..o..o...o...oo....
.oo..oooo..o..o.o.o.
.o.o.....o...o...o..
