10.ox
......o.oo....oo....
.o....o.....oo....o.
.oo...........o..o..
..o.......o...o.....
......o.o.....ooo...
oo.............o...o
ooooo..........o....
o.....oo.o....o....o
...o...o..o...o...o.
...oo..o.........o..
