10.ox
........oo..oo.ooo..
...oo......o..oo..o.
..........o..o.....o
...........o.....o.o
.....o..o.o...ooo.o.
....o..o.o..ooo.....
.o.o...o.....o.o.ooo
.oo..oo.ooo......o.o
.........o...o.o....
.....o..o......o....
