10.ox
...o..o.o......oooo.
.o......o..o.o...oo.
.........oo...o...o.
..o..o.ooo.....ooo..
.o...ooo............
....o..o.o....o.oo..
.oooo.o..o..........
....o........o......
..o..ooo..o.o..o.o..
o..o..o.oo...o..o.o.
