10.ox
..o......ooo........
...o..o.o..o......oo
..oo..o.......ooo.o.
o................o.o
.o....o.o....o.oo.oo
..o.....o....o..o...
o...o.............o.
.....oooo...........
....................
.o......ooo......oo.
