10.ox
.o..o...o...o.....o.
.o...oo.....ooo..o..
........oo.ooo.o....
..oo.o.o.o.ooo..oo.o
oo.o.o...........o..
................o.o.
.o.oo..oo...........
o.....o....o.o......
..o...o.oo.o.oo..o..
.....o.oooo.o..oo..o
