10.ox
o.oo........o.......
.....o.o..o......o..
..............oo.o.o
o.ooooo........o....
.........o.oo.o.o...
.oo..o...o..o...o...
..........o....o.o..
.....o.....o......o.
ooo.....oo.oo.o...o.
o.....oo...oo.....o.
