10.ox
...o.oo.......ooo.o.
..............ooo..o
.......o...o........
..o..o.....o....o...
.oo.oo.....ooo.o..oo
......oo....o.......
....................
o....o..........o...
.....o.......o......
...oo.....o.........
