10.ox
....oo..............
......o.....o..o..o.
.o....o.oo..o......o
o......o............
..................o.
....o..ooo..ooo..o..
........ooo.o.o.oo.o
..o............o....
.o......o......o....
.o....oo..........o.
