10.ox
oo.........o...oo..o
......o....o........
...oooo...oo........
.o..................
o.......o.....oo....
.........oo..o.oo..o
o..........oo..o...o
...........o........
..o......o...o...ooo
....ooo.............
