10.ox
.....o....o.........
...o..o...o.........
o..o.....oo..o.oo...
......o.....oo...o..
...o....o.......oo..
.......o..o........o
..o....oo.o...o.....
.....ooo...o....o...
oo..o.o..o.o......o.
.oo.o..o.o....o..o..
