10.ox
.oo..o.o.....o.oo...
..o.ooo.o.....o.....
.o.oo.....o...o..oo.
oo.......o.ooo...o..
..oo.....oo..o......
......o.o.ooo..o..o.
......o...o....o....
o...o......o.oo.....
......oo...o.o.o...o
oo..o..o....o......o
