10.ox
.o.......o...o.ooo..
...oo....oo...o.o...
.o................oo
......o..o...o.o.o..
o..o....o...........
............o...o...
..oo..ooo...oo..oo.o
..o.......o.oo...oo.
o..oo....o...oo.....
.o...o..o.....o..oo.
