10.ox
...o..oo....o.......
............o.ooo...
..ooo...............
oo..o.....o.o......o
........o.o..o...oo.
..o...oo...o.o.o.o..
.oo...oo..o...oo.o..
................oo..
.o.oo.....o...o..o..
.......o.......o.ooo
