10.ox
o........oo.oo......
..o.o.o..o.........o
o....o.o...o........
..o.....ooo.o...o..o
.....o...o......o.o.
.o......o....oo.....
....o...o...oo....o.
..oooo.oo...o......o
o.o.o.o....o....oo..
.....o.....o........
