10.ox
o...o.ooo....o....oo
...ooo...o......o.oo
..o.......oo.oo..o..
.....o.........oo..o
...o....o..o...o....
o....o....oo.o......
oo.......o.o.o......
...ooo.........o.ooo
............o..oo..o
.o.....o...o.....oo.
