10.ox
...o....ooo.oo....o.
.o.....oo.oo....o...
o.........oo........
.......o......o...o.
......ooo.o......oo.
.......o..o.o.....o.
....o...............
.o.........o..oo...o
..ooo...o.o....o....
..o.o....o.o...o..o.
