10.ox
..oo..o....o.o...oo.
.........o.oo..oo...
..oo.oooo.....oo....
......o....o.....oo.
.............o......
..o.....o.....oo....
....o..o....o.......
....o.....ooo.......
....oo..........oo.o
oo......ooo..o......
