10.ox
.....o..o.o..o....o.
o......ooo...oo...o.
.o.oo..o.o...o.o....
o.o.....o.o..o....o.
o.o...o...o.......oo
.o....o....oo.o...o.
.oooo...oo..o..ooo..
..o....o............
........o...o.oo....
o.o.oooo............
