10.ox
.....o...o........o.
.........o..o..o.oo.
o.........o.........
...oooo...o.o...o...
....o.o.......oo....
o....oo.oo.oo....o.o
..oo.o.o..ooo.o..o..
o..............o....
oo...oo.ooo.......o.
.....ooo............
