10.ox
.o.........ooo......
......o..o..o...o...
o.......o..o...o....
...o...o...o..o.o...
..o...oo...........o
ooo...o.....o..o.ooo
oo...o.o....o....o.o
...o..o......o......
o.o....o...o.o......
....o..........oo...
