10.ox
.o........o....oo..o
..oo.....o..........
o..o.......o.o..o...
....o....o......o.oo
oo.o..oo...o.....o..
.......o.....oo.....
oo......oo.......o..
...........o........
....o..o.....o.....o
o......o.o........oo
