10.ox
.....o.o..o.oooo...o
o.o.......o.........
oo...o.o...o..o.o...
...o...oo.......oo.o
o.o...o...o....o..o.
oo..........o......o
...o......o..o..o...
...o...o.o.o..o...oo
...........ooo......
.ooo..o.o....oo...o.
