10.ox
..o...o..o.........o
.o.....o.oo.o.......
......o..o......o..o
..o....oo.ooo.oo.o..
.o.o..oo...o..o.....
..............ooo..o
...o.........o.o.oo.
....o......oo.....oo
.o....ooo...o.o....o
...o......o...oo...o
