10.ox
...o..oo.....o..o...
....o..o..oo.o.o....
o.....o.........oooo
o.o...o...oo.o....o.
o..........oo..o....
.....o....o......o..
oo...o......o.......
...o......o..o..ooo.
oooo..o.....o...oo.o
.o...........oooo.oo
