10.ox
......o..oo..o.ooo.o
......oo...o...o..o.
..o.....o......o...o
o...o...........o.oo
...oo..o....o.o.o...
....o....oo.....o..o
...o....oo.....o....
..o.o.o.o.o.......o.
..o..........o..oo.o
.o...o.........o.o..
