10.ox
oo....o..o..o.oo....
.oo....oo...........
o.....oo.oo...o..o..
.o.o.o.o..o..oo.o...
....o...............
......oo..o.o.....o.
o..o.oo....oo.o....o
.........o.......o.o
...o...o..oooo.o....
.o.o.o.o........o...
