10.ox
.........o..o.o.....
.o...o.........o....
....o..oooo........o
...........o...o.o..
oo..........o..o...o
...oo.o.o...........
........o.o....oooo.
ooo.........oo......
ooo.....o......o.oo.
.o......o.........o.
