10.ox
............o...o...
o.ooo.......o...o.o.
oo......o..o.......o
...........oo.......
...oo...oo.oo...oooo
.o......o.....ooo...
o..........o..oo..oo
....o.o.....ooooo...
..............o.o.o.
....o......oo...o.o.
