10.ox
....o...oo.....o....
.o....o...........oo
o.o..........o.o..oo
.......o.o.o......o.
.....o.oo..o.......o
.oo.o..o..o......o..
...o.....o..o....o..
.oo..oooo..oo....o.o
...oo...o.....o.o...
...............oo.o.
