10.ox
....oo....o.....ooo.
oo..o.ooo.o......o..
oo.....o.o......o...
....oo.ooo..........
........o.o..oooo...
.........o.o....o.oo
oo..o......o.o......
.ooo.oo......o....o.
......o....o.oo....o
.........o...o...o.o
