10.ox
..o..o..o........ooo
..oooo..o.o...o....o
...o..o.o..ooooo....
..o.oo.........oo...
ooo.oo.....o.....o..
..o....o.o.....o...o
.....oo..o..........
o..o..o.oo.o.o..o...
.ooo.o.oo.o.o.o..o..
..o...oo....o.o..o..
