10.ox
o.o....o.ooo.oo...o.
........o.......o...
o..oo......oooo....o
o..........o.o.o.oo.
..........ooo.....o.
...o.....oo....o.o.o
.........o..........
...o.............o..
...o..o......o.o....
......o.ooo......o..
