10.ox
.............o......
o................o..
....oo..............
o....oo..o.ooo..o...
o..o..o.............
..oo.o.........oo...
o............o......
.....ooo...oo....ooo
o.o..o...o.ooo...o..
.oo..oo..o.o.o......
