10.ox
.....o..o.oo....oo.o
..oo......o..o....o.
o........o....o....o
...oooo.o.oooo.o....
...o...o......o.o.oo
..o...o...o...o.....
....o.......oo......
.....ooo.....o......
.oo.......o..o.....o
...........o..o.o.o.
