10.ox
.o...oo.o........o.o
..o............oo.o.
............o.......
........o.....o..o..
o....oo.o....ooo...o
......oo...ooo...o..
.......o.......o...o
oo.o...o........o.o.
...o.o....o.o......o
.o...oo.o.o.....o...
