10.ox
.......ooo..o.......
..o..o.....o..o.oooo
.......oo.o.......o.
.oo...oo...ooo...o.o
..o................o
o...o.o.o.......o...
...............o..oo
.oo..o.........oo..o
...o..o......o..o.oo
...o...ooo.....oo...
