10.ox
oo.o.oo.o..o.o......
o..o..o..........o..
o..o................
o..o.oo...o....o....
...............o....
o.........o.o....o.o
...o......o...o.oo.o
..oo.....o..o.o.....
o......o.oo.o.o.ooo.
.....ooo..........o.
