10.ox
.....oo......o......
.......o.....o....o.
....oo.o......o..oo.
o...o.o.............
....o...o....oo.oo..
.....o.o.....oo..oo.
.ooo.o...o.oo...o.oo
.....o.o.o.o.oo...o.
o....ooo............
.........oo......o..
