10.ox
....o....ooo....o.oo
...oo...o..oo..oo...
....o..oo.......o...
o.oooo...o.o........
.....o......o.o.o...
oo.o..o.oo.....o.o..
.....oooo.......oo..
...o.........o.o...o
....o........o....o.
o.oooo....o..o......
