10.ox
...o.o.o.....oo....o
......o.ooo...oo....
oo...o..oo..o...oo.o
.oo.o............o..
.oooo.............o.
..oooo....o.o......o
....oo..o.o.........
..oo..o.o.o.o..o.o..
..oo.............o.o
.........o...o.oo...
