10.ox
..o...o........oo...
.........oo......oo.
.o.o....o...o.......
.......ooo....oo....
..........oo...o....
.oo....o.oo...o.....
o........ooo.o......
..o...o...ooo..o...o
...o.........o..o.oo
...........oo..o.ooo
