10.ox
..o.....o..o.....o..
..o..oo........o..o.
ooo......oo......o..
.ooo.....o........o.
..o..oo...ooo...o...
......ooo.ooo..o....
.....o...o....o..o..
.oo.o....o......oo..
o.o..o.......o...o..
.o.oo..........o....
