10.ox
........ooo....o..o.
o...o...............
...........o....oo.o
.....o.o...oo...o..o
o.....ooo...o....o..
........o.oo....o...
ooo...............o.
.........o..o.oo...o
........o.o.........
.o..o...o.oo.oo.....
