10.ox
..o...oo...o....o.o.
..o...o..oo......o..
....o.oo...........o
........o...oo.o.o..
........oo..ooo....o
oooo......o....oo..o
o.o.o....o........o.
....................
.ooo...o....o..o....
.......oooo.oo......
