10.ox
..o..oooo...o....ooo
..o.oo..o......o....
..o.....oo.oo.......
.oooooo.oo.oo..o....
.....oo.............
o....oo.............
o....oo..o.o....o..o
.........o..o...o.o.
.....o..o.oo.....o.o
.o.......o.....o..o.
