10.ox
oo....o......o.o.o.o
o....oo..o.........o
o...o..o.......o...o
..o...........o.oo.o
o.o...oo.....oo.....
.o.....o....oo.o...o
...oo.o.....o.ooo...
.................oo.
.....o.....o.ooo..o.
oo.....o...oo...oo..
