10.ox
oooo......o......oo.
...o.oo.o..o....ooo.
.o..........o.......
................oo.o
.o..o.....o......o..
....o....o...ooo.o..
........oo..oo.o...o
.................o..
.....oo.oo....o...o.
.o.o.o..o..o...o...o
