10.ox
...o..ooo.o...o...o.
...o.....o........o.
...o..o.......ooo..o
o.oo..oo.o.........o
o...o......o...oo.o.
o.....o.o.......o.oo
...oo...o....o.oooo.
.............oo...o.
........o......o....
...o.....o..o....ooo
