10.ox
...o.o..o.oo.....o..
o....o..............
oo.......o.o.o......
......oo........o.o.
.o...o.....o..o.....
....o..............o
....o..ooo....oo.oo.
...o...oo...o.......
o............oo.....
o.ooo.o..oo.......o.
