10.ox
..oo..ooo...........
...o.......o....o...
.o.......o.o.....o..
o...oo...o.oo..oo.o.
.o..oo.o......o..o..
....o.o..ooo.o......
..o..........o......
.oo.oo....o......o.o
.oo..o.o......o..o..
..oo.o.o...o..o..o.o
