10.ox
.....o.......oo.ooo.
...o......o.oo......
...........o...o...o
....o.o....o....o..o
.........o.o....o..o
..o.....o..........o
...................o
...o...........o...o
.o....o.........oooo
...o..o...oo........
