10.ox
o...oo........o...o.
.....o........oo....
..o.o..........o....
....ooo.o..o...oo...
....oooo..oo....o.o.
...oo....o.o.o..ooo.
.o.o...o..ooo.ooo...
o.o.oo..o..oo..o..o.
.o..........o.o.ooo.
......o..o.....o..o.
