10.ox
...o.....o..........
oo......o.........oo
o..o.oo..o......o...
..oooooo..o...o.o...
..o.......oo.ooooooo
..oo.o...oo...oo....
.oo.......o.o..o...o
o.......oo..oo...oo.
....................
.........o....o.o..o
