10.ox
o.o...o....o......o.
o...oo......o..o....
.ooooo....oo.....o..
...o..o.....o....oo.
.oo.o..o........o...
...o........o...o.o.
...o.....o..........
.....o..o...o.o..o.o
...o..oo..o.........
..oo..o.o.o......ooo
