10.ox
o..........ooo....o.
..o.o.o......o...o..
...o.........o.o..oo
...........o........
o.o......o..o.......
...o..o.o..o....o...
o.o....o.....oo...o.
o.oooo........o.o...
....o.oo..oo...o.oo.
oo.o.......o.o......
