10.ox
.ooo...oo.o.o.oo....
.....o...o.o.o.o....
.....o.o.o..o..oo...
....................
.....o..o...........
.oo.....oo..o.......
..............o...o.
o.o..o...o...o.o...o
.........oo....o.o..
o.......o.........o.
