10.ox
.....o..........oo.o
....o...o.ooo.......
ooo....o...oo.......
............o......o
....o.o....o....o...
.............o......
o.o..ooo..........o.
....ooo.oo..oooo..o.
o......ooo....o.o..o
..oo..oo..o..o.o....
