10.ox
...........o..o..oo.
..o.o...o...........
..o.o.....o.o...o..o
.o.o..o......o.o.oo.
.ooo...o..o.o.oo.o..
o......oo.o.........
.....o.oo...........
...o.o..............
o.o......o....o.....
.o.o........o..o..oo
