10.ox
....o.....oo....o...
..ooo......o.......o
......oooo..o...o...
..o.o...oo..........
...........o..o.o...
.o.oo..o.o.......o..
oo.........o.o.o....
.......o............
.oo...o..o....o....o
...o...o.o........o.
