10.ox
o..o..o.....oo......
.......o.o...ooo....
......oo....oo......
....oo..........oo.o
..ooo..o...o....o...
o...o.o.......o.....
.........o.o...o....
o....oo.........oo..
...........o......o.
...o.......o.o..o...
