10.ox
..o.o...oo..o.o.....
....oo...........oo.
.o.o.ooooo..o...oo..
.....o........o.....
ooo.o...oo....o.....
.....o..o.oo......oo
......o..o.......o..
....o..o.o.........o
....o...o..o...oo...
.o....o.oooo......oo
