10.ox
..............ooooo.
.o...o.o.....o...o.o
...o.......o....o.o.
oo..........o.o..o..
o....oo.o...o....o..
..o.....oo..ooo.....
oo.oo.oo...........o
......o......o..o..o
.........ooo.ooo.oo.
...o.......o.....o..
