10.ox
.o.........o..o.....
.o.o.......o.o....o.
.o..o......o........
............o.o..oo.
...o..o..........ooo
...........o........
...........o....oooo
.........o.......oo.
..........o...o....o
.....o..oooo..o.....
