10.ox
..o...oo............
.....oo.o.oo..o....o
o.....o..o....o..oo.
o.oo.o..o.o.........
......oo.....ooo...o
..o.......o.......o.
oo..oo.oo...oo......
...o................
..........o.o.o....o
o...oo........oo...o
