10.ox
o............o....oo
.......o...oo.......
........oo.....o..o.
o..o..o....o.....o..
o.oooo.o..o...oo...o
..........o...o..o..
.....ooo....ooo.o...
...ooo...o...o......
.oo.........oo.o...o
....o..o....o...o...
