10.ox
.....o.....o..o.....
..o.o...o.......oo..
.o.....oo..o...o....
.....oooo..o......o.
.........o..o...o..o
...o.o.....o....o...
.....oo....o.o.ooo..
.o...........o.ooo..
...............o.o.o
..o.....oo.....o...o
