10.ox
...o..o..o.o....oo..
o.....oo....oo......
.....o.oo.o..oo.o.o.
...o......o..o...oo.
o.ooo.o.o.......o.o.
o....o.....o.o......
..oo.....o.o.oo.....
o........oo....o....
o.ooo.o..........oo.
..oo...o..oo....o...
