10.ox
.......o.o........o.
o.....o.......o.o...
......o.......o.o...
.....o.....o.o......
....o..o.......o...o
o.....o....ooo..oooo
..o.o.....o....oo.oo
.o...o.oo.....o..o.o
o.........o.o...o...
.....o...o....o...o.
