10.ox
o...o....oooo..oo...
o............oo...o.
..o..............o..
....o.o....oo..o....
.o.o..........oo....
.o.....o...o........
o.o.............o.oo
o....o...o.....o...o
.o....o..o.o........
o...o...o..o.o......
