10.ox
...o........oo......
o.........o..oo.....
ooo.o....o.o........
...o.oo.o.o....o....
o..o..o....o....oo.o
.....o.......o..oo..
...o.oo.......o....o
.........o...o..o...
.o...............ooo
...o....oo..o....o..
