10.ox
..o...........oo..oo
.o..o...............
....o.....o....oo..o
..o......oo.o.......
o...o.......oooo...o
...ooo.....o...o...o
..ooo..oo...oo.oo...
.o...........o...o..
.......oo....o...o.o
o.......oo....o....o
