10.ox
...............o..o.
..o....o........o.oo
o.oo.o..oo..o.oo..oo
.........ooo........
o....o....o.o..o....
o.....o..o....o..o.o
ooo...oo......o.....
....o.o....o..ooooo.
......o.o......o..o.
.o...o.......o.ooo..
