10.ox
....o..o..o....ooo..
o..o..o.ooo.o.o..o..
.....o.......o.o....
...o..o..o........o.
......o...oo...o..oo
o..oo.o...oo.....o..
..ooo..ooo....oo....
.o...o.o...oo..ooo.o
o..o..o.....o..o.oo.
..........oo........
