10.ox
............o..o...o
..oo.oo...o.o......o
.ooo.......o....ooo.
...o..o......oo...oo
.......o.o....ooo...
........o.....o.....
........o........o.o
...............o.o..
.....o..o...o.o.o...
...o....o.o..oo..oo.
