10.ox
....o.......oo.....o
o........ooo........
.oo.o.........o.o...
.o....o.o...o...o...
o.o.o.....o.o.......
...o..o.ooo....o....
..o......oo...ooo...
........o.....o.....
.o.oo.o.....o..oo.o.
...o.....o.o..o.....
