10.ox
...o.o.oooo.....o..o
..o......oo...o..o..
...o..o.........o..o
............oo.o....
o........o....o.o.o.
.oo.......o.........
.o.oo......o.o.o....
...o.o...ooo...o....
...o.....oooo......o
........oo.o.oooo...
