10.ox
..ooo..o...o...o....
..o..........o..oo..
.......o..o..o......
ooo..o..o........o.o
o..o.....ooo..oo.ooo
....o.o........oo.o.
................o...
........o..oo.....o.
..o.....o.o.......o.
...........o.....o..
