10.ox
.oo....o..o..o......
oo.o.....o.o........
..o.................
....o.oo..........o.
ooo..o.o....o...oooo
.....o...o.o......oo
.o.oo..............o
..o....ooo..........
o.oo..o.........oo..
...o....ooo.....o.o.
