10.ox
o.o.....o.....o..o..
...o...o........o...
...o...o.......oo...
.....o..oo...o..ooo.
........oo..o...o...
oo...o.....oo.......
.o........ooo.o...o.
...o.........o......
..o............o.o..
............oo..o...
