10.ox
....o........o..o...
.o.o..o..o.ooo......
o.o.....o........oo.
..o..o..o.........oo
ooo..oo.....o...o..o
.........ooo........
......o.............
....o............ooo
....o.oo.o........o.
.....o.oo.o.o.......
