10.ox
.o............o...oo
..o....oo.oo........
.o...o...o....o..ooo
.......oo...........
o...o.........o..o..
...o..o.o...ooo...o.
oo...........o......
..o.........o.......
o..o.o..oo...o....oo
.oo..o..o...o.......
