10.ox
....o....o....o.....
......o..oo.........
.......o.oo...o.....
.o.....o...o.....o..
.............oo..o..
.oo........ooo....o.
...o....ooo.oo...ooo
.....o...oo..o.....o
..o..o....oo........
........o...........
