10.ox
..oo....o..o..o...o.
......o........oo...
oo......ooo....o...o
o.o.o..oooo..o....o.
....o.oo....o.......
.....o...oo...o.....
.o.o..........o.o.o.
.oo.o............o.o
...o...o......oo....
o......oo...o.o.o..o
