10.ox
o.o........o.......o
..o.o..o...oo.......
o.o.o.o.o...o.oo....
o......o.....o...ooo
o...o.oo...o...o..oo
o...o..oo.oo.oo.o...
o.o.ooo........oooo.
.....o..o...o.o.....
..o.o....o..o..o.o..
..o.o...o........o..
