10.ox
..o.ooo.....o.......
o.o...o.....o.....o.
..oo................
....o...o..oo.....o.
..o......o...o....oo
....o.........o.o..o
...o....o.ooo.o.o.o.
....o......ooo.....o
.....oooo.o......oo.
.oo..o..o..oo..o....
