10.ox
..o....o.....o.....o
......o.....o....o.o
.....o.o.......o.o..
....o.o.............
.................oo.
.......oo.o..ooooo..
..o.....o...o....o..
.o..o.o......oo.....
o.oo.o.oo..o.o....o.
.......o............
