10.ox
..o....oo..o.....o..
.........ooo........
oo...o..............
o.....oo......o...o.
.oo.....o.o.oo.....o
o.....o..........oo.
..o..ooo............
...o.o....oo........
oo...o....o........o
...o..o.............
