10.ox
.......ooo....o.o...
o..oo.........o....o
o.......o.......o..o
o..o..o...o....o...o
ooo.........oo..oo.o
...o..oo....o.o.o.oo
...oo....oo.........
.......o...o.oo.o..o
.o.o.......o..o.....
.oo....o..oo.....oo.
