10.ox
..ooo...o..o..o....o
...o...o.......ooooo
....o.......o.......
.o.o..o...o.o...o.oo
...o................
ooo.o.o......o...o.o
.........ooo..o..o.o
...........o........
........o.oo........
................o...
