10.ox
.....ooo....oo.o....
.o....o...o.o...o...
..o..o....oo.o.o...o
.o...o...o.o.oo.....
oo..................
...o........o.ooo...
o.....o...o.....o...
.o.....oo.oooo.ooo.o
o.....ooooo.oo......
o..o.....o.....o...o
