10.ox
.ooo..oo....oo.o..o.
o.......o.o..oo.....
................o..o
..oo..............o.
..o..........o.ooooo
ooo.o...o..o......oo
...o.o...........o..
..oo.o..............
...oo...o.o.oo.o....
.o..o..o........o...
