10.ox
oo.o.....oo.oo.oooo.
..oo.o....o.o...o...
ooo....o.o.o...oo...
......o..o..o.......
...ooo........o..o..
.o....o....o....o..o
.o.o...oo.oo.....ooo
......o..ooo.o.oo..o
o...o.o.......oo....
........oo.o.oo...o.
