10.ox
.......o.......o....
o..oo.......o.....o.
........o..o..ooo...
.o........oo...o.oo.
.o.o......o....oo.o.
o...o...ooo...o.....
o.o.....o....o......
...oo..o.o.ooooo....
o......ooo.oo.......
..oo.......o.o......
