10.ox
..o.o....o..o......o
.......o.o..oo..o..o
....o..ooo..........
....oo........o.....
......o.......oo....
..oo.oooooo..oo.....
o...o....o.o...o..o.
o..o.oo........ooo..
o...o............oo.
o........o....o.o.o.
