10.ox
.......o..o...oo....
.....ooo.o.oo..oo...
o.......o....o.oo..o
.o.o..o.o......o..o.
........ooo...oo.o..
.o..oo.o.o.......o.o
o..o...o....o.o.....
oo..o....o....o.o.oo
...oo......o......oo
....ooo.oo..........
