10.ox
......o...o.........
..ooo.oo.o...o.....o
..oo...............o
.o.............o..o.
..o.o....oo..o..o.oo
..............o.o...
.......o........ooo.
...o.o.ooo.o....o...
.o.......o.o.oo.....
...oo.o.............
