10.ox
o.o..o..o.oo..o....o
o..........o......o.
...o...o..o....o...o
.......oo....oo.....
...oo.o.......o.oo..
........o....o.oo..o
.....o...o...o......
...oooo....oo.......
....oo......o.o..o..
...o...o.o.....o....
