10.ox
....o.ooo..o...o.ooo
o.....o..o.oo.......
..o.o.........o...oo
...o...o...ooo...o.o
.....o........o.o..o
..o...o...o.....oo..
.o...o.oooo.o..oo..o
o...o.........o.....
..o.....oo.o.......o
.o.......o..........
