10.ox
...o.oo....oooo....o
.o.......o.o....o..o
.oo......o......o...
..o...o.o.o.o...o.oo
.o...o.ooo..........
.....o.oo..o....o...
....o...........oo..
...o.....o..oo..oo..
o.ooo....o..oo......
.......o....o...o...
