10.ox
..o..........o.....o
o..oo..o.......o..o.
.......o.........o..
.o...ooo...o........
o........o........oo
..ooo.oo.ooo.ooooo..
ooo...o..oo....o....
......o.oo.o....oo.o
o.....o.o...o.......
...o.o.....oo....oo.
