10.ox
..o...ooo..oo.oo....
.......o.o........oo
.o...o............o.
...oo..o.....o.....o
o..............o....
o..o.........o....o.
....o..oooo.o.oo....
..o.....o.o...ooo...
o.o.....o...oo.oo...
............o.....o.
