10.ox
..o...o....o.....o..
.o...oo.............
oo..o....o.....oo..o
ooo..o.o.o...o......
........oo.......oo.
....o......o......o.
.o...o...oo..oooo..o
............o..o...o
o......o......o.....
o...o.o.....o.....o.
