10.ox
..o.o.o...o...o.....
.o.........o.....o..
....o....o...o..oooo
o..o.o.......ooo....
....oo..oo.ooooo.o..
..ooo........ooo....
..o.o...o.......o.o.
o..ooo....oo.......o
oo...o..o...o.o.oooo
........o..o.ooo.ooo
