10.ox
...o................
o....oo..o..o....o..
..ooo.....o.oo.o..o.
..o...ooo..........o
..o....o..oo........
o..o.o.............o
.o.....oo..o.o...ooo
........o...oo......
..o....oo........o.o
..o.o.........o...o.
