10.ox
o.o..o....o..ooo..oo
.oo.....o.....o.....
.o.o...oo...oooo...o
...o....o....o.o....
.oo..o........o...o.
o..o.o..o.o.oo...oo.
......ooo..o........
...o..oo..o.........
.oo....o.ooo.....ooo
...o....o.ooo.......
