10.ox
oo............oo.o..
...o..oo...o......o.
o...o...o.......oooo
.o...........o.o.o.o
.o....o....o.....oo.
.o..o........o.o...o
......oo...........o
................o...
.......o..oooo.....o
ooo.o...o...o.o...o.
