10.ox
..oo...o.o.o...oo...
......o...........o.
.o......oo..........
o.o.oo........o.oooo
.o.o.....o.o..o.....
o..........o....o...
o....oo.............
.........oo.o.......
..o......o..o.......
......ooo..o..oooo.o
