10.ox
oo.oo....oo.o..o....
.o...o..o.......o.o.
......oo.o..oo.o.ooo
.....o..............
..o...o..o........oo
o..oo.......oo.o..oo
.ooooo.o.o..o.....o.
..o...oooo..o.......
.o.....o.ooo........
.........o....ooo.o.
