10.ox
o...oo.....oo.....o.
...o.............o..
.......oo......oo.o.
o...........o......o
.o.....oooo...o.o.oo
....o....ooo..o.....
o............oo..o..
.o....o...........oo
o...o..........o....
......oooo...o......
