10.ox
ooo.o.o......oo.....
..o..o.oo........ooo
............o..o...o
oo....o.............
...........o..o.....
oo...o..o..o........
...............o..o.
.......o....o..o...o
..o......o....oo....
o..o...oo.....o....o
