10.ox
......oo..o....ooo..
......oo...o...ooo..
....o......o.....oo.
.oo............o.o..
.............o.oo..o
o........o.o........
..oo..ooo....o.o....
..............o..o.o
.o.o.....o...o.o....
.o.o..ooo..o.oo.....
