10.ox
o..............o...o
.o.........oo..o..oo
o.....ooo.o.....o...
o.o.o.....o..o....o.
..o.....o.....o....o
...o.....o..........
...oo.oo...........o
.......o.o.o.o.o....
.o..o.o.........o..o
.o.....oo.o...oo..oo
