10.ox
...o.......o.o......
...o.....o......oo..
...o.o.o...ooo......
................o...
ooooo..oo...o.....o.
..oo.o.o..o.o.o..oo.
...o.........o.o...o
.ooo............o...
.oo.......oooo...o..
o....oo......o......
