10.ox
......o..ooo..oo....
....o......o...o.o.o
oo......oo....oo..oo
.oo.oo.....oooooo...
...o....o.o....o....
...o..o.o....oo...o.
...o..o......o......
...o...........oooo.
o.o.oo.o...o.....o..
.o..o..o..o..o.o.o..
