10.ox
.....o..ooo..o.o....
..........o..oo.oo..
.............o.o...o
....o.....o......oo.
...........o....ooo.
.o......o....o..o.o.
....o.o.oooo.....o..
.....o.oo.....o.....
.o......o...ooo....o
..oo...o....o..o.ooo
