10.ox
.ooo............oo.o
.............oo.o...
...o.o....o..o..o..o
...o.....o.o...o....
.oo.................
...........o........
......oo...ooo....o.
...o.o...o.....o.oo.
ooo..........ooo....
......o........oo...
