10.ox
...o..o.ooo.o.......
.....o.......o.ooo..
o.ooo...o.........o.
......o.............
o.....o.....o.o....o
..o..ooo.....o..o...
oo.....o..o....oo..o
o...oo..oo......oo..
.......ooo..o....o.o
..o.....o..........o
