10.ox
.......o.o...oo.....
..oo.oo........o....
.o....o....oo.......
.......o.....o.....o
.....o.o........oo.o
.o........oo.oo....o
.o.o.o....oooo.oo...
o.o...o....o......o.
....o.........o...o.
....o.....o..oo..o..
