10.ox
ooo......ooo...o..oo
...oo...............
.o.....o......o.o.oo
.o.........oo.....o.
o.ooo.o..o.....o....
o.....o......oo.....
........oo.o.o.o..o.
.......o......o.....
.o...o...o...o....o.
o.................o.
