10.ox
....oooo..o........o
ooo...o.........o...
..........o...o..o..
oo.oo....o...o......
....o...............
....o.........oo..o.
..o.......o...o.....
....o......o.o..o...
...oo.o......o....o.
...o....oo..ooo..o..
