10.ox
.ooo...o.......o.o..
..........o....o..o.
...oo..o...o.o...oo.
.o...o..ooo...ooo.oo
ooo.................
o.o...oo...o...o....
...........o..o.o...
o............o......
...oo.....oo..o.....
..........oo.o......
