10.ox
......o...ooo..o...o
....o...o.o.....o...
......o.......o...o.
o..oo.....o......o..
................o...
...ooo....o....oo..o
.........o....o.....
.......o....o.o.oooo
.....o.....oo...o.o.
o..oo..........o....
