10.ox
o..oo.oo.ooo........
o..o..o...........oo
..o..o......o.......
o...o....o....o.....
oo......oooo..o.o...
.....oo......o......
oo...ooo.o..........
o..........oo...o.o.
..o......o.....o.o..
...o..o..oo.......o.
