10.ox
.......oo......o....
o....o..o.....o.....
...o..oo.....o....oo
......ooooo..o...o..
...oo.........o..o..
....o..o...........o
.......oo.....o..o..
.....o.o..o......o.o
...........o........
...............o....
