10.ox
o..oooo....o...o....
....ooo...oo.....o.o
o......o..........o.
..................oo
....oo......o......o
o....o............oo
..o.....o...oo.oo..o
..............o.....
oo..oo.....o...o.o..
oo.........o..o.o..o
