10.ox
..o............o..oo
oo......o...o..o...o
o.....o........o...o
ooo.......oo....o...
o..o.........o.....o
....ooo..oo......oo.
........o.o..o......
...................o
.........o..oo...o..
...o..oo....o...o...
