10.ox
.o.............oo...
.o..........o..o..o.
..o...oo............
o...o...o.o.......o.
o.o.......o..oooo...
.o.o...oo.o.o....o..
.o.......oo.ooo.o..o
..oo.oo.....o.....oo
.o...o....oo.....o..
........o..o.o......
