10.ox
.o..oo..oo.ooo...oo.
o.....o....o.o.o.o..
o..o.o..o...o.oo...o
...o........o.o..o..
.ooo.oo.........o..o
.o...o..o...........
o..o.......o.oo.....
...o.......o...o.o.o
....o.........o.....
o..o....ooo.o......o
