10.ox
.......o...o.o.o.o..
..o.ooo.....o...o...
.............ooo...o
.....oo...oo.....ooo
.o.....oo...o.o..o..
.......o.oo........o
..............o..oo.
...oo....oo.o.....o.
......o.o..o........
....o.....o.........
