10.ox
......o........ooo..
..........o.....o.o.
oo........o..o...o..
o..o...o....o.o.o..o
o....o..............
o...o.o.oo..oooo....
.....oo....o.o..oo..
.....o...o.oo.o.....
.........o.........o
o.........ooo..oo..o
