10.ox
o.oo......o....o....
..o.oo.......oooo...
......o..oo.....o.o.
.o.ooo.oo...o.o.o...
..oo....o....o..o...
...o.o..oo.oo.o.....
..oo........o...o.o.
...o...o....o....o..
.o........o.o.o..o..
...o.o.......o....o.
