10.ox
ooo.ooo..o.oo...oo..
o....o..o..o..o.o...
o..o..oo.oo..o....o.
.......o....o.oo..o.
....o.o..o.oo.......
o.oo.oooo..o..o..o..
o...oo..o....o..o..o
.oo......o..o.o.....
..oo...o....o.o.o...
........o..o.......o
