10.ox
o.o.............o...
.....o.o..........o.
ooo.oo.oo..ooo.o....
o...o........o....o.
o...................
..............o.....
.......oo..........o
..ooo..oo.o.oo......
.........o....o..o..
....o...o....o.oo...
