10.ox
o..o.........oo.oo.o
o.o..o.oo.....o.....
.....oo....o....o..o
oo..........o......o
oo.......o..oo.o..o.
....oo....ooo....oo.
...o.....o.o......oo
.oo.....o.......oo..
o......o.o......o.o.
o........o......o...
