10.ox
....o...o.oooo......
....o.........oo...o
..o...o...o.o....o..
..o.....o..o....ooo.
..o..........o......
o....o.....o........
.o.o...o...oo...oo..
o..o.oo.........o.o.
o.o.o.o.o.ooo..o....
o.oo..o.o.....o....o
