10.ox
......oooo...o..o...
..o.................
.oooooo....o..o.....
..o......o.o......o.
o................o..
.o....o.oo..ooo.o...
o....o......o....o..
....o..oo.....o.....
.....ooo..o.....o...
o..oo.ooo.........o.
