10.ox
.o.o..oo.oo.oo......
.............o....oo
.o..o.......o.o.....
........oo.....o.oo.
....o.........oo....
o..................o
....oo...o.....ooo..
.o...o.......oooo...
..oo.o.........o..o.
..o..oo............o
