10.ox
o..oo...........oo.o
.....o..........o...
.....o....oo.....oo.
..o..o.........oooo.
o.o.........o..oo...
.....o...o.o........
o....oo....o.oo.ooo.
.o..o.......o.......
.o.oo.........o.oo..
....oo......o.oo....
