10.ox
..o......oo..o..oo..
......o..o.....oo...
oo....o....o.o.oo...
...o.o..............
.oo.....o.o...o...o.
.oo.oo...o..o.o.....
o..oo.o.o.o.........
o...o....o...oo.....
.o..oo...oo.ooo..o.o
..o...o.oo.o..ooo.o.
