10.ox
.....oo.oo..........
oo...o.......o......
.....o.o..ooo.o.o...
....................
........o....oo.o..o
oo.o....o...........
....o........ooo....
o......o....oooo...o
..o.o...oo.......oo.
.oo..o...oo..oo..o..
