10.ox
.....o....oo.......o
..o.oo.......ooo....
.........o...o..o...
.o..o..o..o..o.o..oo
......oo.ooo.o..o...
o..o...o.o.o..o.....
o....o..o...o.......
..o..o.....o..o.....
.o.o....o......o....
o........o........o.
