10.ox
....oo..o.o.....o..o
o.o...oo.....o......
..ooo..o.oo..oo....o
..o..o.o.o....o...oo
oo.......o..o..o.o..
oo...........oo....o
o......o...oo...oooo
.o........o......o.o
.oo.oo.............o
.............oo...o.
