10.ox
....o.ooo.....o.....
..o....o......oo...o
.o.....o..o...o...o.
......o....oo.o..o..
o...o...o...........
.oo...o..ooo........
.....o....o.........
oo.........oo...oo.o
.......o.o...oo.o...
..........o.....o..o
