10.ox
o..o..o.........oo..
....o...o.......o..o
....o...............
o..ooo.oo.........o.
o.....o..o...o......
...o..o.o.o..ooo..oo
..ooo.o.......o.o.oo
.oo........o........
.o....o....o....o.o.
..o........o........
