10.ox
o...........oo...oo.
......o....o........
..o.o..oo..o..o.....
...o..o.o.oo..oo..o.
........oo....oo..o.
o.........o.........
.o.oooo.ooooo...o.o.
oo......o.oo.o....oo
.o........o..o....o.
.o.ooo...........o..
