10.ox
......oo.....oo.....
.....o..............
.........o..o.o.....
...o.......o.....o.o
ooo..oo.o..ooo....o.
.o.o.....oo.o..o....
..oo.o.......o..ooo.
o...o...............
.o......o.oo........
..oo.oo....ooo...o..
