10.ox
.o...............o..
o......o.....oo....o
oo..o.o.......o.o...
o.o..o.....o.o......
..o.......o.o.....o.
o..........o.o.....o
..ooo.........oo.o..
.o......o....ooo....
.o...ooo.o.......oo.
.....o...oo.o...o..o
