10.ox
.....o....oo.o..o...
.....o.o..o.....oo..
....oo.....o...o....
..o...oooo...oo....o
oo..oo......o.......
o......ooo..o.......
.oooo....o.o..o.....
.oo...........o.....
........oo....o.o...
o...o.........o.....
