10.ox
.o.ooo..............
o....o.oo...........
.o.o..o....o......o.
.oo.o.....o..o......
.................o..
.o........o.....o.o.
oo.o........o...o...
.o..o..o...o.o....o.
.........o.....o....
...........o.oo.....
