10.ox
.oo.....o.....o.o...
.o.....o....oo.ooo..
....o............o.o
..o.........o..o...o
..o.o.o.........o.o.
............o....o..
.o...ooo.....o..o..o
o.....o.o.o....o.oo.
.oooo...o.........oo
.o.o..oo.......oo...
