10.ox
.........o.....o.o..
....o.......o...o.o.
.o..........ooo.....
oo...oo.ooo..o.....o
.o.oo.oo.o...o......
......o...oooo.o.o..
...o..o.........o.o.
.oo......oo...o.....
....o......oo...oo..
o...o.....o.....o...
