10.ox
.....o...oo.o.oo....
..oo...oo..o...oo...
..o.o......o..o.....
.o.......o..o...o...
..oo.o.....o........
....o...........o...
oo....oo...........o
....o.........o...o.
.....o...oo...oo...o
....o..o....oo.....o
