10.ox
..o..o..oo.....o..o.
.o.ooo.o...o.o..oo..
..o..ooo.........o..
..oooo.o.oo...o.....
......o..o....o.....
.o....o....o.oo.o.oo
.ooo.o...oo.o.o..o..
oo.o..o.............
o...o............oo.
....oo.......o...oo.
