10.ox
...........oo....o..
o..o....o....o..o.o.
.o.o..o.........oo..
.........o..ooo.....
.......o.....o.o...o
...o....oo.o..o....o
...o.o..o....o..o...
...........o....o..o
..o.....o...o.......
..o...o..o...o.o.oo.
