10.ox
.o....ooo...........
.oo.o.o.o.o.....ooo.
....oo......oo..oo..
...o......o..o..ooo.
.....o.o............
.....ooo...........o
.oo...o..o....o.o.oo
...o..oo.o......o.o.
.........o....o.o...
o...........o.o.....
