10.ox
....o..oo.o.....o.oo
o..o..o.........o...
...o.o..o......o....
..o.o..o...........o
.........o.o.o.o.o..
o.o..o.oo.....oo...o
o........oo....o..oo
.........o..oo.....o
..oo..oo.ooo.oo.o.o.
..o..ooo.........o..
