10.ox
..............oo....
.o...o..o.......o..o
oo..o...o......o.o..
..o........oo.ooo..o
....o.....o......o..
o.........o.o.o...o.
......o..o.......o.o
....oo.o........o.oo
....o...oo..oo.o..oo
...oo............o.o
