10.ox
.o......oo.....o..oo
..oo...o...o........
..o.o.o.........ooo.
......ooo...o.oo....
...........o.....o.o
.o......o.oooo......
.o..o..o.oo....oo..o
.o...........o....o.
o...o...o...o......o
.o..................
