10.ox
.oo.o.o....o.o...o..
....ooo....o.o.o.o..
...o...oo..o....o...
.........o.....ooo.o
.o.oo...o.oooo......
...oo..o....ooo....o
o..o...o.o.o...o...o
o.....o.o.o...ooo..o
o....o.oo...........
...o.o.............o
