10.ox
.o......oo.o...o.o..
...o..o.............
....o.o...........o.
..o...oooo....o..o.o
.........oo..oo....o
o.............o..ooo
o........o....o.....
.....ooo.ooo.o...o..
....o...o..o.o.o...o
.....o..ooo.o.......
