10.ox
o....o..oo....o..o..
......o.o...........
.o........o.....oo..
o.o...........o.....
o.......o.....o.....
..o........o.o...oo.
.o.........oo.oo....
...ooo..o..o...oo..o
....o.........o...o.
.oo.o...ooo.oo.....o
