10.ox
o....o.....oo.......
.o.o.ooo....o..o....
o.o....o.ooooo.....o
..o........o....o...
......o....oo.....o.
ooo.o......o.....o..
.........o.oo.oo....
...o...............o
.o.oo....o....o...o.
..o.........o.oo....
