10.ox
......o..o......o.o.
....................
........oo....o.....
.o.oo.......oo.ooo..
..oo..........o.....
o..o...oo....ooo.oo.
.o..o..........o..o.
..o.o...o....o...o..
......o.o........o..
..oo.oo...oo.o...o..
