10.ox
.................o..
o..o..o...o..o...ooo
...oo..o......ooo..o
o.oooo....oo...o.o..
......o..oooo..o....
.....o..oo..o.......
o...o.o.o.o..o.oo...
o..........o..o.....
o..oo.....o..o.oo...
..o...ooo..oo..ooooo
