10.ox
.....oo...oo.o....o.
.o.......oo...o...o.
..oo.o.o.o...oo.....
..o.oo......o.o.ooo.
..o.....ooo.........
oo....o..ooo.o.oo...
.o.oo.o..o...o....o.
.......o.oo.o......o
....o...o.oo..oo...o
....oo......oo...o..
