10.ox
.....ooo.o.....oo...
.o..o....o.......o..
.....o.o.........oo.
...oo...o...........
......o..o..o.o.o...
o....ooo...o..o...oo
.o....o.o...o.oo....
o.o......o.......o..
..o....o.........o..
..........oo..o...o.
