10.ox
.....o........oo.ooo
..o.o.........oooo.o
..o....o......o.o..o
o.....oo...oo....o..
.........o.........o
o.....o.o.......o...
....o...o.oo.......o
....o.o.oo.o...o...o
.o...............o..
o.o..o.o.oooo.......
