10.ox
ooo......o..o.o.o...
...o.oo.o.......o...
o.o.ooo........o..oo
oo.............o...o
.o.o.o....o.o.o...oo
.....oooo.o.........
oo...o.......o....o.
o....o..oo.o..o..o..
...o.ooo.......oooo.
......oo....o..o....
