10.ox
.........o..oo....o.
o.oo.......o........
.........o..oo...o..
.......o.......o....
.o..o.oo.......o....
....o..o.oo..o...oo.
...o..o.....o...o...
..ooo.oo.o...o...oo.
.o.oo.oo...ooo......
...oo........ooo.oo.
