10.ox
o.....oo..oo.....o..
...........ooo....o.
ooo.o..o......oo.o.o
..o.....o...........
o..o..........o...o.
.........o....o.....
.o............ooo..o
.o...o......ooo.....
.o......o.o.o.......
.....o...o.o..o...o.
