10.ox
oo.....o......o.o...
.o...o....o.....o...
....ooo.oo.....oooo.
ooo.o..o.......o....
....o.o.o.o.........
...o..o.ooooo.o....o
....o..o...o........
o...o...............
o..o.....o...oo.....
.....o..o.oo...o.o..
