10.ox
..o..o....ooo.ooo...
ooo......oo...o....o
...o...o.o.o...o....
.....oooo...o..o.o..
.o....oo........oo..
............o.....o.
o.........o..oo..o..
..o...ooo......oo...
oooo..o..o..oo.o..o.
....o.o....oo.......
