10.ox
.......o.....o.o....
.o....o..o.........o
.oo..o...oooo....oo.
.o.o.o.o...o....o...
..o.oo......o....o..
o....o..o.........o.
...oo.ooo.o.oo......
oo..o....o.....o...o
....o...o.........o.
..oo.oo.oo..o.o.ooo.
