10.ox
o..........oo..oo...
....................
oo....ooo.....ooo...
oo...........oo.o.o.
o.......o........o..
oo...oo.oooooo..oo..
..oo..o.o.o.....o..o
.oo....o.oo..o......
..o.....o....oooo...
o....o....oo..oo....
