10.ox
.o..o......o....o...
o...o....o...o.o....
.o........o.......o.
.o...ooo.o...o.o.o.o
.oo.oooo........o...
...oo.oo..o....o..oo
..oo.o..oo.....ooo..
..oo.......o.....o..
.........o...o.oo..o
...o...oooo.......o.
