10.ox
.o.o..o..o....o..o..
o.o..ooo..o.oo......
o......o...o......o.
.oo...o..ooo.ooo....
..o...oo..oo....o...
.o.o....o.o.........
o..o.o........o.o.oo
o......o....o.....o.
.o....o..o..o...o..o
...oo..o......oo....
