10.ox
...o....oooo.......o
.o..o..o..o.......o.
...o......o...o...o.
...oo........o...o..
o.....oo.....o.o.o..
.o...o...o.......ooo
..o.o.............o.
oo.o...o...o.....o..
.o.ooo..o.oo..o....o
oo...........oo....o
