10.ox
oo.........o.oo..o..
..ooo....o.o.......o
..o.oo......ooo..ooo
....o.oo.o.....oo...
ooooo....o.......o.o
....oo......o..o..o.
.........o....o.o...
o...oo...o.....oo..o
o.oo.......o.o..o...
.......o.........o..
