10.ox
o..oo....o..oo.o..o.
o..oo........o.o..o.
....o..o..o..o......
.o...o.oo.o....oo..o
..o.......o..oo..o.o
..o.................
.....o.....oooo..o..
o...o...o...o..o.ooo
..o...o....o......oo
ooo......o.o..o..oo.
