10.ox
o...oo.o...o.ooo...o
o...o.oo...........o
........o.......o...
.o.o....o......o.o.o
..o.o.o...oooo.oo...
o...ooo......o....o.
..oo................
...oo...o........o..
...o.o.........o...o
....o...........o...
