10.ox
.......ooo..........
.o......oo..o...o...
........o........o..
..o.o..oo....o.o...o
o.ooo..o...ooo......
o.....oo.....o...o..
....o......oo.o...o.
..........o.o..o....
.oo..o....o..o.o..o.
...o...ooo...o.oo.o.
