10.ox
.....oo.o........oo.
..o.ooooo.......o...
o....o...o.......o.o
..o...oo......oo....
....o.ooo...oo......
o...o..o.o.o........
oo..o.o...oo....ooo.
.o..o...ooo..o....o.
.oo.o.....o.o...o..o
oo...o..o.......oo.o
