10.ox
o....ooo.....oo....o
.o..o....o...o......
.o.....o...o..o.o...
.o.....o........oo..
.o..ooo.oo..o.oo....
o...........o...o...
..oo......o......o..
o.....o.o..o.oo...oo
....o.o...o....o..o.
...o..........oo.o..
