10.ox
..o........oo.......
o..o.........o.o..o.
oo.........oooo.oo..
......oo........o..o
....o......oo..o....
....o.ooooooo.o.o...
o..........o.o......
.......o.......o....
..o............o....
.o.o..o....oo.....o.
