10.ox
...ooo......oo.o....
o...o.o.ooo......ooo
o.o.o.o..oo...o..ooo
o...o...........oo..
.o.....oo.o.o...o.o.
.o.......o...o......
..ooo.....o.........
o...o..o.......o.o..
.o......o.o.o.o..o..
.o......oooo......o.
