10.ox
.....ooo...o....o...
..oo...o..o.o.ooo...
..oo......o........o
o.o.o...o.oo........
..o..........o...o..
.....o.......o.o.o..
o......o....oo......
.........o..........
......o.......oo.ooo
....oo.....o....oo.o
