10.ox
.o..ooo.......oo...o
.....o..ooo...oo..o.
..oo...oo.....o.o..o
...o..o.........o...
....o.o.o.....ooo...
.o.o.oo.o....o....oo
..o...........oo..o.
...o...ooo..o....o..
o.........o...oooo..
.o.....o.....oo.....
