10.ox
oo.ooo...o..........
....o....oo..o.....o
...o...o..o.o.o....o
.o..o....o..........
..o..oo.....o.......
.o..o...o..ooooo...o
..oo.o.......o.oooo.
....o..oo....o.....o
...o....o.o.o.......
........oo.......o..
