10.ox
o..o.....ooo.o.o.o..
.........o..oo..o.o.
......o....o......o.
......o.o.....oo....
ooo.....o..o...oo.o.
.o.........o.o......
..o...o..o..o....o..
....o......o...o.o..
..o.....o........oo.
...o......o.o.o.....
