10.ox
....o...o..o.oo....o
.o.......o..o...o...
....oo...ooo.oo..o..
oo...oo......o......
o.....o....o......o.
o.o.o..o.....o....oo
..ooo..o.o......o.o.
......o....oo...o..o
.....o..o.o.........
...o....o..o.oo..ooo
