10.ox
o.....o....o..o.ooo.
o...o......oo..oo..o
....oo.....o...o....
.....o..o........o..
...o.o.........o....
....o.....oo.o...o..
..............o.ooo.
.........o.o....o.o.
.....ooo.o.....oo.oo
..oo.o....o.o.o....o
