10.ox
......o..o..........
ooooo.......ooo..o.o
......o.....oo...o..
.oo..oo..oo..o.....o
..........oo...o.o..
o.o.......o...o.o..o
..o........o.o......
...o................
.o..o.....o..oo...o.
...o.oo....o..o..oo.
