10.ox
.......o....o.o..o..
...o...o.....oooooo.
..oo.o......o..o..oo
....o......oo.o.oo..
...o......oo.ooo....
.oooo........o..o..o
........o......o.o.o
oo.o.oo....o........
oo.............o....
o..o...o...oo.......
