10.ox
oooo.o........o...o.
ooo...........o....o
........o.o......o..
..oo...........oo...
..................o.
....o.....o....oo..o
.o..o.o...o...o..o..
..o....o.ooooo.oo.o.
.ooooo..........o...
......ooo....ooo.o..
