10.ox
o.............o.oo.o
.o...oo...o.....o...
.o...o......o.......
......o........o....
o......o....o...o...
.....oo..o..o.......
...oo.....oo..oo....
..oo..o.....o..o..o.
.oo......o........o.
...o...o......o.o..o
