10.ox
....o.....o...o.....
..oo...o.oo...oo....
o.ooooo.....oo...o..
oo.....o.....oo.....
.oo.o.o...o.o.o..oo.
o.o......o.........o
........o....o..ooo.
...oo...o.oo...o.o..
......o.......o...o.
o......oo.....o.o...
