10.ox
o............ooo..oo
.......oo..o........
..oo..o..o..o.....o.
o....o..............
..o........o..oo.o..
...o.o..o.....o..oo.
....o..ooo...o.o..o.
....o.o.o.o.ooo.o...
.o........oo..o.....
.o.........o....o...
