10.ox
.............o.....o
o..o...o.o.o.o.....o
o.o......o....oo....
....o.o...o....oo...
.o.................o
.......o......o.....
....o...o..o........
.o..oo.oo.oooo.....o
...o.o..o......o...o
...o....o.......o...
