10.ox
o..........oo....o..
............oo......
ooo..oo.........o...
........o.ooo..o...o
.....oo..ooo..o.....
..o..o.o...o.....o.o
...........o.....o.o
........o.o.o..o....
.oo....o....o.......
o.....o.o...........
