10.ox
.o.....o.oo.o.....o.
o.oo.o...o....oo..oo
.oo....ooo......ooo.
..o.......oo.o.....o
oo..o........o.oo...
o...o.......o...o...
.o....o.o....o......
..o.o.....o.....o...
...o..o.o.......oo..
o......ooo..o.o.....
