10.ox
o.....o.o.......o.oo
.o..ooo........oo.o.
....oo.o.o..oo.....o
.....o.......o..o...
o...o..oo..o..oo.oo.
......o.....ooo.o...
o.....o.............
...o.....o.o....o...
....o..o.....o......
.o.......o....o.o..o
