10.ox
..o..ooo..oo..o.....
o..o.o...o........oo
.....o..o...oo..o...
.oo........o........
............ooooo..o
.o.......ooo....o...
.....oo.ooo.o......o
...o..o.....o....o..
...o....o.....oo....
...............o....
