10.ox
.ooo.oo.oo..o.o...o.
...........o.o.o....
o..o....o.o....o.o.o
.........o..o..o..o.
o..o...o.....o.....o
....o.o..o..o......o
........o.oo.o....o.
.o.o.........o...oo.
.....ooo.......o....
..o..o....o........o
