10.ox
..o..o........o...oo
oo...o..o...o.o.....
.ooo.o.....o...oo...
..o..o.oo.oo...o..o.
.........o..........
....o.o...o.oo......
oo.o..o.oo.o........
o....ooo........o...
o..o..ooo..oo....o.o
........o..o.o..oo..
