10.ox
o........ooooo....o.
.o......o.o.....oo..
..........oo.....o..
........o...........
..o........o..o...oo
oo..o......o........
.o...oo.............
..o..o.oo.oooo..o.o.
...........o..o....o
.oo.o.......o...oo..
