10.ox
o.........o......oo.
.o.o.o....o.oo......
....oooooo...o....oo
o.o.oo..o..o...o.ooo
.....o......o.oo....
oo....oo.o........o.
................o..o
...oo.........o..o.o
...........oo.o.ooo.
.oo..o..oo.o......o.
