10.ox
oo.o...o.......o....
..o.o..o..o.o.......
.oo...o....o..oo.o..
..o.ooo..o..o.......
.o.....o.....o..o...
.o....o..o.o..oo....
.....o.....o......oo
oooo........oo....o.
..oo....o........oo.
.............o..o...
