10.ox
.o.......o..oo.oo...
..o.o..o..........o.
...o..ooo...o..oo...
.....oooo....oo.oo..
.o.o...o.....o....o.
..ooo.o..o.o........
...o.........o.o....
.o....o..o.oo...oo.o
....oo.oo.o....o..oo
..o..oooo...o.o...o.
