10.ox
.......o..o...o.oo..
....o......o....o...
...o..o.o...........
oo...o.o.......o.o..
...oo....o....oo....
o......o...o..o...oo
.....o............oo
....o....o..o..ooooo
.o......o..o...o..o.
...o...ooo.....o..oo
