10.ox
......o...o.o......o
...ooo......o.....o.
.........o...oo.ooo.
ooo................o
.......o.o..........
.....o.o.ooo..o.....
.....o.o..o..oo..o..
o..oo...o.........o.
..o..o...o........oo
oo..oooo.......o.oo.
