10.ox
o..oo........o.o.o..
o..........o........
o.o.....oo...o..o...
o....oo...o.oo..o..o
o...o....o....o...oo
oo..o.....oo..o.o..o
......oo.o.........o
...o.......o.....oo.
o.........oooo......
o.oo....o...o.......
