10.ox
.ooo.oooo...o.......
.o.o.............o..
......o....o....oo..
.oo...oo....oo..o...
...........oo..o....
oo...ooo..o.........
o..o...........o....
o..oooo.ooo..o......
o........o..o.o.....
......o...ooo..o....
