10.ox
......o.o..o.oo.....
....o..o.....o..o..o
......o..o..oo.o....
..oo....o.o....o.o..
ooo..o...........oo.
.ooo..o.....o.o..o..
.....o.o.........o..
o.o...o....o..o.....
.oo...oo..oo.o.o....
.o...oooo.o.........
