10.ox
oo....o.o.o.....oooo
oo.....oo.o.........
ooo.o...o...o....o..
...............o....
.......o...o....o...
..oo...o.......o....
..o...o......o......
.......o....o..o....
o..o.o.o....o...o..o
o....o..ooo.ooo.oo..
