10.ox
oooo...o.o.o.......o
..o..o............o.
.....oo.o.o.o..o....
...o..o..o...o...o..
.oo....o....o...o...
...o...........ooo..
...o.oo....ooo.o....
o.....o..o.o..o..o.o
...o.......oo..o..o.
oo.o...o......o.o..o
