10.ox
..o.........o.....oo
...oo....o...o....oo
.ooo..o...o.........
..o....o.ooo..oo.o..
..oo.oooo..........o
oo........oo.o.o....
..oo..o...o....o....
.o.o..o......o.o...o
.........o...ooooo..
o..........o...o....
