10.ox
oo...........ooo....
...o............o.o.
..o......oo...o..o.o
....oo.............o
.....ooooo..o.o....o
...oo...o........oo.
..o...ooo....o..o...
.o...oo....o....o.o.
.......o..o.........
.o..o..o..o...o...o.
