10.ox
........oo....o.ooo.
...o........oo....oo
oo......o.........o.
....o...o..oo.......
o........o.o...oo...
..oo......oo...oooo.
..ooo..o..oo.......o
.o......oo....o.....
..........oo...o...o
......o......o......
