10.ox
o.o.oooo.......o..o.
....oo..o....o.o..o.
...o..........o.o...
.......o............
o..o.....o.o......o.
..o....oo..........o
.........o...o......
..........o...o...oo
ooo.o........oo...o.
.....o..............
