10.ox
....o..o......ooo...
.........oo.o.o.oo..
o.....o........oo...
o...........oo.....o
...o.........o......
.oo.o.............o.
o....o.....o......o.
...o.o...........oo.
........oo..o.o...oo
.o.ooo.ooo.ooo.o.o..
