10.ox
...o...o..o...o.....
...o..o..oo..o......
..oo.....oo..ooo.o.o
.oo.oo.o.o..o.ooo...
......o...o.........
oo.....oo..ooo....oo
......ooo......o.o..
o..o.oo...oo.oo.o..o
o.o..o.ooo.o....o...
..oo............oooo
