10.ox
o...........o.......
..ooo.....o...o..oo.
...o.ooo....o.......
..o...o.....o.o.o...
o.....o.....o.ooo...
......oooo......o...
..o..oo.o.......o...
...o.o.o...ooo......
o.....o..o........o.
o...o..o....o.......
