10.ox
.......o.....o.....o
o..ooo.o..o..o.oo.o.
.........o...o...o.o
.....o.ooo....o...o.
......ooo..ooo.o...o
o.......o...........
.o..o.o.......o...o.
...................o
...o....o........o.o
o.....o.............
