10.ox
..........o.....oo..
.....o..o.o....o....
o.........o...o....o
....o..............o
.........o.o...o.o..
o.oo.o..o.o.........
......o......o..o.o.
.o...o.oo...........
.....oo.oo..oo......
.........o........oo
