10.ox
.oo.o.ooo..o...ooo..
.........oo.o.......
.o..o......oo.......
.....o......oo....o.
.o.........o.....o..
...o.oo...........o.
.o.oo.......o..o....
........o.......o.oo
..o...........o.o...
..o.o...oo...o......
