10.ox
...o..o........o..o.
.o.o........o.o.....
..o..o..oo..........
.o..o...o.....o..o..
.....o......o.......
....o...o.o........o
o.......o.o...o....o
.......oo..oooo...oo
o.o..ooo.oo......o..
ooo....o.o...o..oo..
