10.ox
............o.oo.o..
....o....o.o..o.oo.o
o...ooo....o.o..o...
......o...o.o..o.o.o
..o...o.............
.o..oo.oo..o..oo...o
.o.oo.oo..o...o..o..
o.......oo..oo.....o
.o.......oo..oo.o...
...........oo.......
