10.ox
.....ooo.o.o.o..oo..
..o.ooo.....oo.o..o.
....o.o....o...oo...
..........o.oo..o...
..oo..........oo...o
.o...oo.o......o.o..
.o.o..oo..o.....o...
..........o....o....
o.ooo...oo....oo....
o..oo......o....o..o
