10.ox
o...oo.oo.....oo....
...o.....ooo.oo.oo.o
.........ooo.....oo.
..o.o..o..oo.oo.....
..o..o...........o..
......o.............
........o.oo.o.ooo..
.........oo.....o...
o.......ooo....o....
..oo.ooo....o..o.o..
