10.ox
....o...oo..o...ooo.
o......o.o.oo...o...
..o........o..o.....
.....oo......o..o...
.o...oo.o.o..o......
.oo...o...o.........
..o.o.....o...o...o.
...o..o.o.o..o......
ooo.......ooo....o.o
...ooo..o...........
