10.ox
.oo...oo..o..o....o.
.o.....o...o..oo....
.o..o..o...o....oo..
oo.............oo.o.
......o..........o..
o.o.......o.....o.oo
.........o.o....o...
...........oo..o...o
o..o........o.......
ooo.........ooo.o...
