10.ox
o...o.o...oo.....o.o
...o....o.o.....ooo.
...o...o......o...o.
..o..o.....o.oooo.o.
...o.o..o..o..o...oo
o...o.o.....o......o
......o..........oo.
...o......o..o..oo..
oo.....o.ooo.......o
...ooo....o....ooo..
