10.ox
o.......ooo......o..
....o.....o..oo.....
.o................o.
...........o........
....oo......oo..oo.o
o..o.......o........
o.oo.....o.ooo...oo.
ooo.o.o..o...oo..o.o
...o...o............
.......o.o.......o..
