10.ox
..oo......oo.o.o.o..
...oo..o.o.......oo.
.......o.o.o.o....o.
oo.o.o....oo........
oo.......oo.......oo
..oo.o....ooo....o..
oo...........o..o..o
..o....oo.o.o...o.o.
o..o...o.o....oo....
oo..................
