10.ox
.o.....oo.oo.ooo..o.
...o....o..........o
..........o.o..ooo.o
................o..o
..o....ooo.o....oo.o
..ooo.oo.o.o...o....
o.....o.oo.....oo.o.
........oo.oo...o...
.o.o.....o......o.o.
o........o..........
