10.ox
ooo...o.......o.o...
..o..o..o....o...oo.
.o....oo.o.........o
.....oo..oo...o.oo..
o...o.....o....o....
.ooo........oo.....o
o..o....o...o.o....o
o.o..o.o.oo........o
.o....o.o..o.oo.....
o.oo..o...oo...o....
