10.ox
...o.....oooo.....oo
....o.o.oo....o.o...
..oo...o...o........
...o....ooo.o.oo.o..
...o...oo..o.oo.....
..o.oo......ooo.....
.o....o.......o.....
...o..o........o...o
...o............o.oo
..o.o.........o.....
