10.ox
..o..o........o..o..
oo..o..o......o...oo
o......o......o...o.
..o.ooo.o..o..o..o..
.o..oo.o.oooo.......
o..........o..oo...o
...o.o.......ooo..o.
......o..o.o....o.oo
..o.o.o.o.o.........
..ooo..o..o..o......
