10.ox
o.o....o.o..oo.....o
...oo....o....o..oo.
..o..oo.o...oo.oo.o.
.....o...oo.........
.oo..o....ooooo.oo..
o.......o.o.......o.
o.........o.o.o..oo.
....oo....o......o..
o.o........o......o.
o....o....o..o..ooo.
