10.ox
......o..o....o.....
.o.o...o.......o.o.o
o........ooo.o......
......oo..oo..oo..o.
oo..........o..oo...
......o..o.oo.......
.oo.....o..o..o.....
o..o.....o........o.
......o.........o...
....................
