10.ox
.....o.o.oo...o.o.o.
oo.o......o.......o.
......o........o..o.
.o.......o...o.oo.oo
.....o...........o.o
...o.....o.oooo...o.
.ooo....oo......o..o
o.oo.o..o...o.o..o..
....o............ooo
..o...o............o
