10.ox
.....oo...o..o......
.o...o.oo....o...o..
.o.o.......oo...o...
.o..oo..o.o.........
.oo.o.o...oo.o...oo.
........o...o.o.....
...o...o..o...o.....
........o.......ooo.
.oo......o..ooo..o..
o.o..o.....o........
