10.ox
oo.....o.o...o..o...
...o.o........o.....
..oo..oo....ooo....o
............o...o...
o.......o......o..oo
.o.ooo..oo....o.....
.ooo.oo....o........
......o.o...........
..o....oo....o......
..............o..o.o
