10.ox
...o..o.....o.....o.
o..............o....
oo.o.ooo...oo.......
.ooo.oo.ooo.....o...
..o.....oo.oo..o....
o......o.o.o...o...o
.o..o...ooo.oo.o....
........ooo......oo.
.....o.o..o..o.o...o
.o.....o....oo.....o
