10.ox
..oo....o.......o.o.
.....o..............
..oo.o.o.....o.o....
oo.oo.o...o..o.o...o
.o..o....o.o...o....
o.....o.o.....o..o.o
..o..o.o.o......o...
.....o..oo..........
...oo.oo.........o.o
.o...oooooo...o.o..o
