10.ox
...o...............o
o.....o....ooooo....
............o..o....
.o.o....o..o.o...o..
.oo......oooo.......
.o..o..o.o.....o...o
o..o...o..o.o...o...
.o..o..o.o...o..ooo.
..........oo.......o
.oo.oo..o.o.o..o..o.
